,round,id,user_id,screen_name,text,attitudes_count,comments_count,reposts_count,total_engagement
0,-1,5.1E+15,7750033999,叉叉小屁,基基怎么分八个瑞士卷//@乒乒帕帕:太典了我仿佛看到�上的爱当爹的赘男人了。。,201,0,0,201
1,-1,5.1E+15,5997542052,拆家的饭全都是黄磊做的,叔们是真糊了瑞士卷怎么分这种都没人桃了,3,3,0,3
2,-1,5.1E+15,7362070292,镇山猪哥,瑞士卷到底怎么分？媳妇能吃饭后小甜品吗？看东北人是怎么回答的。#瑞士卷L镇山猪哥的微博视频,11,2,0,11
3,-1,5.1E+15,5474626826,沉迷鲸鱼的小烟yu_,瑜约云奇超话顾顺就应该是另一款北燃之子楚一寒性格随爸，性情暴躁，一点就着，长相随妈顾顺性格随妈，情绪稳定，长相随爸震北以后打算怎么分瑞士卷啊?震北：顾儿想吃几个吃几个，他俩不会自己买啊,145,9,0,145
4,-1,5.1E+15,2408988485,可爱预告,所以八个瑞士卷应该怎么分L可爱预告的微博视频,1162,218,62,1224
5,-1,5.1E+15,5899648833,-布布BuBu-,八个瑞士卷星核猎手会怎么分#崩坏星穹铁道##星穹铁道二创#L-布布BuBu-的微博视频,23,13,9,32
6,-1,5.1E+15,5841821344,爱听郭德纲的厨子,李云天评书砸挂“八个瑞士卷”#瑞士卷怎么分##李云天##德云社#德云社超话L爱听郭德纲的厨子的微博视频,12,0,1,13
7,-1,5.1E+15,7949938954,Project7不粘锅,【�】耗狗是怎么分瑞士卷的,205,54,68,273
8,-1,5.1E+15,2478296471,科技测评狂人,#瑞士卷事件各方调查已介入#【“瑞士卷事件”真假难定，短视频摆拍何时休】#瑞士卷事件被质疑是剧本#据扬子晚报：近日，有关“8个瑞士卷怎么分”的视频上了热搜，视频中的女子自称是全职宝妈，与丈夫就家中八个瑞士卷怎么分、谁能吃一事起了争执。该事件引发“全职妈妈困境”“瑞士卷自由靠自己”等话题，讨论席卷全网的同时也被质疑是剧本，各方调查已介入。全文>>O“瑞士卷事件”真假难定，短视频摆拍何时休,58,24,0,58
9,-1,5.1E+15,7134700718,v脸小鼠鼠,八个瑞士卷怎么分？,19,36,0,19
10,-1,5.1E+15,7927732332,八十稻羽混的帮,2583【搜查队】八个瑞士卷怎么分,541,24,32,573
11,-1,5.1E+15,7726917402,被狮子男硬控一辈子,问:八个瑞士卷爱恩季6个人怎么分答:全给邓佳鑫吃，再点杯奶茶，因为邓佳鑫是氪金top实力主唱门面��,64,8,1,65
12,-1,5.1E+15,7649129545,鱼卷_不要困,八个瑞士卷怎么分我全部吃掉让他们再给我买八个没吃够,0,1,0,0
13,-1,5.1E+15,7908036490,404青你站,【】提问劲爆：八个瑞士卷怎么分江谷光:霓虹金打呦不吃瑞士卷07:黑咖喱和敏敏哥各三个我两个吧�敏敏:只有八个吗☺,13,1,0,13
14,-1,5.1E+15,5824859454,恋鼠狗妹,瑞士卷八个TF四代怎么分张亦然：八个都给左起寒陈均铭：八个都自己吃掉，想了想不太好又扣了半块给左起寒掌柜元：起寒一个，亦哼一个，波纹一个，剩下的准备放冰箱留着当早餐自己吃，结果被韩瑞偷吃了张韩瑞：让大家一人对他说一句好话看心情给，王鲁杰不用说先分三个，掌柜元说完了分0个左起寒：桂圆一个，俊铭一个，亦然一个，亦哼一个，围城一个，韩瑞一个，波纹两个羊波纹：妈妈不允许吃那么多甜食不健康所以打算八个都给起寒，结果看完起寒分的之后打算匀一个给桂园匀一个给军民陈亦哼：已经想好了一个给起寒一个给亦然一个给桂园结果头天晚上太馋了一不小心全吃了,153,2,94,247
15,-1,5.1E+15,3815502387,夏吱秋,底层男人没有爱情，雄竞一路高歌，顺风顺水的男人，尤其是年少成年的，对女人是真的有很多保护欲的，给钱也是真的大方。大概类似于“我已经拥有很多了，给别人分点也无所谓”半路起家，从底层升上来的，或者雄竞一直失败的，对女人的保护欲已经很少了。因为拥有的很少，所以脑子里都是，“该怎么让她在我这里利益最大化呢？”底层男人没有爱情的，或许8个瑞士卷都不让你吃是真的。,13,0,0,13
16,-1,5.1E+15,1722796230,哎呦呵JC-T多多爱洣,怎么办！吃了一半的瑞士卷怎么分？哈哈哈哈哈哈哈哈哈哈,15,17,0,15
17,-1,5.1E+15,2533739170,小兰兰无剧不欢,#林一的伴手礼有瑞士卷##林一送追剧团瑞士卷#这怎么分哈哈哈,0,0,0,0
18,-1,5.1E+15,1689974542,健康顾班长,【#一个瑞士卷的热量相当于一碗米饭##医生提醒瑞士卷不可吃多#】近日，“瑞士卷怎么分”很快引起全网热议，甚至不少网友晒出自己狂“炫”瑞士卷的截图。11月6日，国家注册营养师、湖南省胸科医院营养科主任张胜康提醒，一个瑞士卷的热量相当于一碗米饭，不宜多吃。（文李琪视频高煜棋）L健康顾班长的微博视频,0,0,0,0
19,-1,5.1E+15,7520471923,老张奔小康,瑞士卷怎么分？家有儿女还是太超前了,8,18,0,8
20,-1,5.1E+15,5171986047,哎呦是我喽,“我要吃果子”“我能吃两个吗”哈哈哈哈哈哈倘若有8个瑞士卷猴子你怎么分L哎呦是我喽的微博视频,79,6,7,86
21,-1,5.1E+15,1798336172,Sandy絮児,沈月穿搭，好好看，可可爱爱，小小一只瑞士卷怎么分，这对cp也没有逃过，真的好磕，继续撒糖。LSandy絮児的微博视频,86,8,6,92
22,-1,5.1E+15,1902256024,青春的泥沼,前一阵，怎么分瑞士卷上了热搜，好家伙，这几天七鲜超市把瑞士卷促销了。全国各地卖瑞士卷的人成了赢家，关键是味道也就那样啊。#瑞士卷怎么分##瑞士卷当事人称非常后悔并抱歉#,0,2,0,0
23,-1,5.1E+15,1051749147,点芯小宅,就瑞士卷怎么分那个事儿，真的离谱。追溯到源头就是一位全职妈妈怎么分瑞士卷蛋糕引起的，不管是真是假，带动流量是真的开始了。某书、各大直播间开始卖瑞士卷了，盒马也是执行力挺强的，借势营销是让你玩明白了。我说网上那么多卖货的都要先演个没脑子的情景剧是为了什么呢…,24,6,2,26
24,-1,5.1E+15,1820206877,内娱女主,《家有儿女》还是太超前了，8个瑞士卷怎么分，刘星早就给了我们答案，各位对这答案可还满意？,40,7,0,40
25,-1,5.1E+15,6244540051,LoverPoetry_金钟云情诗集,金钟云超话#艺术声带金钟云#艺声超话241111艺声迷你六辑一直�视频签售�：如果我和哥哥是夫妻，有两个孩子，我们四个人有八个瑞士卷，欧巴要怎么分呢？☁️：这说的是什么话？四个人分八块蛋糕…(�:对)☁️：就一个人吃两个呗！�：哦～欧巴是个冷静的人啊！如果是我的话，欧巴都吃了都行☁️：那怎么可能都吃掉！有八个呢…�：就…多吃点吧欧巴(工作人员说时间到了)☁️：(笑)总之，多吃蛋糕哦～(挥手再见)(Cr.小光小光)LLoverPoetry_金钟云情诗集的微博视频,507,53,79,586
26,-1,5.1E+15,6987364443,薄荷绿乌龙,33Svan超话“八个瑞士卷怎么分我自己吃八个我爱吃点瑞士卷爱吃点瑞士卷”好好好大馋丫头谁吃的过你啊爱吃多吃L薄荷绿乌龙的微博视频,136,5,0,136
27,-1,5.1E+15,1680351757,点开娱乐君,林一沈月《失笑》送的伴手礼！林一送的瑞士卷也是吃到了（很想问问瑞士卷林一怎么分？#失笑微博追剧团#林一超话,371,74,16,387
28,-1,5.1E+15,7811733866,ww的恋爱日记,瑞士卷的风还是吹到了我身上��&��背靠背，屁股贴着屁股，我看电视剧，他看游戏直播��扭头，捅咕我两下“你说，你要是有八个瑞士卷你怎么分”��“都给你吃，胖你一个人身上”��“那要是有宝宝了你怎么分”��“都给你都给你”��“嘿嘿幸福”��“你要是有八个瑞士卷你怎么分”��“我也都给你啊”��“孩子呢”��“啥好吃的他都想吃啊”��“谢谢你，但是我现在想吃桃酥了”��“买！再买点别的，明天拿着当零食”,130,20,0,130
29,-1,5.1E+15,5053946625,欢乐星球计划,搞笑超话#熏鸡销量#就很离谱，八个瑞士卷怎么分事件，导致山姆、盒马的瑞士卷卖爆了，山姆卖了十多亿，盒马没公布，觉得蹭这个流量会被反噬，但是阻挡不了人们玩梗的热情。电商的朋友说，青团、熏鸡也卖爆了…,0,0,0,0
30,-1,5.1E+15,5053946625,欢乐星球计划,#熏鸡销量#就很离谱，八个瑞士卷怎么分事件，导致山姆、盒马的瑞士卷卖爆了，山姆卖了十多亿，盒马没公布，觉得蹭这个流量会被反噬，但是阻挡不了人们玩梗的热情。电商的朋友说，青团、熏鸡也卖爆了…搞笑超话,0,0,0,0
31,-1,5.1E+15,6133905875,MD小姐姐Yuqi,回复@Holly年华似水:前两天是瑞士卷怎么分//@Holly年华似水:无语了,14,4,0,14
32,-1,5.1E+15,5138734984,InaMokYingXin,#熏鸡销量#什么是熏鸡知道的解释一下《再见爱人4》播出至今，“麦学”异军突起。要说互联的热潮真是不休不止前段时间流行怎么分瑞士卷，最近不少人又被“熏鸡”刷屏了。,21,7,5,26
33,-1,5.1E+15,1798445977,瑞文戴尔De星,#瑞士卷怎么分#要不说嘴毒还得是抖人，昨天在抖看到的瑞士卷视频，说ip在山东的，别问老公瑞士卷怎么分，就看打够级的时候你跟老公做对门他让不让你开点太狠了。妥妥的源自生活的铁锤啊。,1,0,0,1
34,-1,5.1E+15,6364387634,椰爺欧耶,王俊凯超话如果你有八个瑞士卷现在有成朗马亮庄文杰周正四个人你该怎么分？理由呢,667,128,37,704
35,-1,5.1E+15,2081296667,生活在辽宁,【东北人怎么分瑞士卷】“八个瑞士卷，如果好吃，我应该看不见，如果不好吃，我应该会吃七个半”这用分呐？！东北男人约等于剩饭处理机　刻在基因里的东北传统。L龙头视野的微博视频,7,0,1,8
36,-1,5.1E+15,7717693891,yu圈小妹,快来学#8个瑞士卷怎么分#已笑死Lyu圈小妹的微博视频,0,0,0,0
37,-1,5.1E+15,2255913581,沈阳身边事,【东北人怎么分瑞士卷】“八个瑞士卷，如果好吃，我应该看不见，如果不好吃，我应该会吃七个半”这用分呐？！东北男人约等于剩饭处理机　刻在基因里的东北传统。L龙头视野的微博视频,10,0,0,10
38,-1,5.1E+15,5885542232,小狗旺财,快来学#8个瑞士卷怎么分#已笑死..~L小狗旺财的微博视频,103,0,0,103
39,-1,5.1E+15,6633024917,千椰卷绘派,严江/葱花鱼一盒瑞士卷怎么分？步重华大概会因为保持身材一个不吃，然后以吴雩的味觉尚未痊愈为由也不让可怜的小鱼吃，于是严峫喜提瑞士卷一盒，并把两盒瑞士卷都给了江停。吴雩因无法忍受瑞士卷就这么离自己而去，偷偷地就溜到了严江家里，在表哥表嫂的掩护下顺利在步重华杀来之前吃完了半盒瑞士卷……最后可怜的小鱼被拎回家又一顿爆炒。,3,6,0,3
40,-1,5.1E+15,5367249470,逸行的治愈星空,女孩们，别跟着骗你们流量的人打女拳，这拳打得再好也带不给你财富与幸福，真正有用的拳是技能拳、资本拳、思维拳。30年前，很多(没说所有)男孩子在研究《大众软件》时，大量女孩子(没说所有)在看琼瑶；20年前，大量男孩子在研究编程与互联网商业，同时大量女孩子注册个论坛账号天天只研究找对象和美容……在过去的每个时代转折变革的节点，肯磕新技术，肯学习新应用，肯勇闯新商业模式的女孩，一直比男孩少很多。如今智能时代来了，你们觉得那些天天追恋综、天天呐喊的主题只有嫁与不嫁、生与不生、胖与不胖、瑞士卷怎么分，天天发声与争夺的战场只在微博小红薯评论区里的那些女孩，再过10年，会比已经开始研究AI商业与创作机会的女孩过得更好、还是更差呢？谁在未来会更有权呢？,345,30,45,390
41,-1,5.1E+15,7511849259,吃不吃棒棒糖呀,早上下雨了，我还起晚了，自己不敢开车，就在我们公司群里问谁还没走把我带到公司，然后…然后我们领导说“我！”…然后我就坐领导的车来公司的，路上闲聊问我带了什么早餐，我说瑞士卷你要吗？他说他血糖高不能吃，我说哦其实不怎么甜，他说那行给我来一个，我说好的好的！结果下车给他分的时候也没有多余的袋子，他拿手比划了半天，发现实在是不好拿，最后说那我还是不吃了我血糖高…,8,14,0,8
42,-1,5.1E+15,7370953266,电子寡妇互帮互助中心,【】你和mjg八个瑞士卷怎么分7140,383,146,20,403
43,-1,5.1E+15,6314973807,琪琪睡醒了Qq,三哥姐姐发的去看弟弟们演唱会给弟弟们买了水果和蛋糕所以八个瑞士卷怎么分L琪琪睡醒了Qq的微博视频,11,2,1,12
44,-1,5.1E+15,3036352233,贝吉塔IV,我说的晚婚晚育是指年轻人读到本科研究生毕业，然后靠自己在大城市打拼事业，攒首付定居生活的那部分人你说你如果高中、大专毕业就回老家相亲结婚，或者家里有钱可以啃老养娃，当然是选适龄生育比较好啊…问题是并不是所有的年轻人家里都能帮忙出首付，或者家里有人帮忙带小孩的那怎么办？牺牲女人工作全家靠老公养？找的老公养的起老婆孩子吗？能保证有这个人品和担当吗？老公会不会失业被裁员呢？我说的3个40岁才生娃的宝妈，其中两个都是有自己稳定事业才生娃的一个是自己搞旅游团的，销售性质朋友圈攒了很多客源另一个房地产行业，说有什么证，自己在家带娃还能赚40-50万/年的她俩整个人的状态就很松弛从容了…当然你说自己赚不到钱，不如早点结婚生孩子也可以啊想着靠别人、走捷径，那就只能赌对方人品运气好还可以，运气不好就是上网问八个瑞士卷怎么分了（这其实是大概率，毕竟大部分男人自己也能力有限）我没有鼓吹大家晚婚晚育或者不婚不育只是当年轻人自己都养不起自己的时候，只能说谨慎生育吧毕竟生了可是塞不回去，是要对孩子负责的（男人可以不管孩子，当妈的能跑吗？舍得孩子吗？）,45,5,3,48
45,-1,5.1E+15,1769469393,亟兮般若,我确实无法理解家里有八个瑞士卷怎么分？这种愚蠢的问题会这么流行。这种情况80%的人都遇不到，首先你得有个老婆吧？然后你还得有孩子，一半的人就没了，谁家老婆会给自己亲生的娃买反式脂肪酸爆棚的瑞士卷？就算有，都强势到买了，你还奢望她来问你怎么分？真有基本也离婚了！提出这种逻辑问题的不是单身狗就是没带过娃！要么即将单身。#八个瑞士卷#,377,121,10,387
46,-1,5.1E+15,5729760101,小梦软糖ovo,八个瑞士卷NPC有九个人怎么分？回答：分四顿吃。已知九个人吃两碗重庆小面一盒瑞士卷有八个且瑞士卷能掰成一块一块的所以不过期的情况下一顿吃俩够九个人吃四顿。,64,14,1,65
47,-1,5.1E+15,6970465257,脑袋里想不出一个字,"lingorm超话�#lingorm#今天女朋友突然问我买了八个瑞士卷该怎么分，她好像很满意我的回答，还一起吃了饭哦☺️专栏·lingorm
专栏·limgorm捡手机",140,10,1,141
48,-1,5.1E+15,6124785491,阿画不喜,八个瑞士卷sdfj怎么分?,28,9,0,28
49,-1,5.1E+15,5899648833,-布布BuBu-,人有五名，瑞士卷有八个，怎么分#崩坏星穹铁道##星穹铁道二创#L-布布BuBu-的微博视频,29,13,10,39
50,-1,5.1E+15,7824245054,地团儿,tg中大家的瑞士卷应该怎么分,45,17,0,45
51,-1,5.1E+15,7742256142,菠萝板栗酥my,我有六个瑞士卷怎么分？,78,78,0,78
52,-1,5.1E+15,6109003860,听玉见野,八个瑞士卷到底怎么分八个瑞士卷全都是我吃女儿吃一巴掌儿子吃一巴掌老公更是降龙十八掌想吃的勿近偷吃的更是滚开��,5,5,0,5
53,-1,5.1E+15,7824245054,地团儿,地团儿有八个瑞士卷，怎么分,217,30,6,223
54,-1,5.1E+15,1256363904,顶流颜究社,8个瑞士卷怎么分，《家有儿女》的刘星早就给了我们答案了,251,102,112,363
55,-1,5.1E+15,6173817838,阿碩fjy,家有儿女还是太超前了，8个瑞士卷怎么分，刘星早就给了我们答案，各位对这答案可还满意？,1,1,0,1
56,-1,5.1E+15,7868232144,FIA_TeamRadio,41858【tg】来一点瑞士卷梗，每个车队都有八个红胎，两位车手怎么分？,108,3,14,122
57,-1,5.1E+15,5890166242,龙不给,死他妈烦瑞士卷这个事，能不能别推我了，我一点也不好奇你老公你男朋友到底怎么分。刚刷到的时候以为是女生经济独立的重要性，妈的没想到成了娇妻的狂欢。,560,47,1,561
58,-1,5.1E+15,7638012169,跟着ya轩去冒险,小脆小丸来提问！就一个瑞士卷怎么分呀！,32,23,0,32
59,-1,5.1E+15,5666481149,小叮当娱乐,#电视剧小巷人家##小巷人家实时收视率破1##小巷人家#小巷人家：假如宋莹有八个瑞士卷，她会怎么分？值得女性们学习“瑞士卷”的梗火了，一夜间全国各地的老公，都被老婆问8个或者几个瑞士卷怎么分。有的人求生欲很强，有的则是比原视频里的老公还让人气愤，还有的人求放过。那如果是电视剧《小巷人家》里，蒋欣饰演的"宋莹”，假如她有八个瑞士卷，她会怎么分呢？按照宋莹会好好爱自己的性格，她绝对不会委屈自己的。她可以分给儿子、老公和朋友，也可以全部都自己吃。所以就算宋莹全部吃掉都可以，她是一个该努力的时候就好好奋斗，该享福的时候就好好享福的人。而且啊，她也不是一个会只局限于八个瑞士卷的人，她完全可以吃完再买。主打一个绝不会“没苦硬吃”，而是“有福就享”，也可以“没福硬享”的。在电视剧《小巷人家》里，这是一部年代剧，那是一个奉献和牺牲盛行的年代，懂得爱自己的宋莹是很难得的。她对生活有热爱和追求，不仅为自己而活，也赋予了自己追求幸福的权利。有网友说，她的美，就是对自我价值的最好诠释。（苏小妹/文）在电视剧《小巷人家》里，为了儿子林栋哲能考上一中，宋莹可没少操心，就连”上香“都去了。孩子好不容易考上了，作为妈妈可不得好好放松一下啊。当宋莹穿上漂亮衣服，和姐妹一起放松。她提前说好，让大家不要聊孩子和爱人的事情。因为好不容易不要带孩子，有自己的空闲时间，可不得聊自己感兴趣的话题。毕竟在你是妻子、母亲、女儿等身份之前，你首先是你自己啊。宋莹告诉我们，女人什么时候都要先爱自己，只有你爱自己了，别人才会爱你。而且啊，你都不爱你自己，谁又会来爱你呢？还有啊，别人对你不好，你就更要对自己好，要不然不就变成和别人一起来欺负你自己了吗？（文/小苏）在现实里，尤其是妈妈辈的，小苏看到太多牺牲自己、委屈自己去成全家庭的，结局都不太好。所以小苏希望这些妈妈们，能够在余下的日子里，分出一部分精力给自己，好好爱自己。只要你决定开始，什么时候都不晚，想想宋莹、想想50多岁出走的“苏敏”阿姨。我们就来人间这一趟，孩子也不是只有你一个人的，孩子有孩子的人生、孩子也有他的爸爸、爷爷啊。七尺男儿怎么也比女子身强体弱，所以妈妈们别把一切都往自己一个人身上扛，要不压垮了可没人心疼你，疾病也不会放过你。瑞士卷的梗之所以爆火，就是太多妈妈被压抑、被牺牲了，也希望因此唤醒更多女性的觉醒。你可以硬气一点、可以再多努力一点，以后甭管8个瑞士卷了，就算是想吃一箱又一箱的瑞士卷，也没人敢拦你。,0,0,0,0
60,-1,5.1E+15,6244136813,小汤圆同学,香麦风虎皮瑞士卷1000g，约30个18.9瑞士卷蛋糕烘焙面包鸡蛋糕点心休闲零食食品健康夹心营养早餐#早餐##瑞士卷怎么分#,1,0,0,1
61,-1,5.1E+15,5308585171,羊毛羊Yangmy,断网很久的人突然刷到那个瑞士卷事件，想说如果你看到这个事儿的第一反应，是去问自己对象“瑞士卷应该怎么分？”，那你就完了，你已失权且不自知。这就像你和你对象说你不想生小孩被ta认同后的沾沾自喜一样，本来就是你的子宫，本来就可以不生，你不需要得到任何人的支持。本来就是你买的瑞士卷，想吃几个还需要别人先同意吗～不要被分配的好就高兴，重点是不应该被分配，你自己要当分配者。,279,31,7,286
62,-1,5.1E+15,7877313732,WHIB_CJES,"WHIB超话AnD,8个瑞士卷怎么分~#跨海营业记##WHIB当值微博小编#",43,99,10,53
63,-1,5.1E+15,5230757817,七不七桃,丁程鑫超话网速为0的主播对“8个瑞士卷怎么分”的认真回答嘎嘎真诚是永远的必杀技！L七不七桃的微博视频,303,8,32,335
64,-1,5.1E+15,7652623939,看我干嘛我在练肩,瑞士卷怎么分？我自己吃,2,14,0,2
65,-1,5.1E+15,6540424837,种草小海龟,八个瑞士卷怎么分？我直接一口气吃10个——点�评论抽一个姐妹吃瑞士卷【23�】熊治动物奶油瑞士卷700g共10个跟着龟龟步骤价格就是成立的，动物奶油！现做现发！还有泡沫箱+冰袋发货发货！！某音搜同款700g竟然要59.9跟着龟龟薅20多就到手了[得意]折2.6/块！一盒吃五种口味！口感细腻，不甜不腻！淡淡的奶香味，做早餐和下午茶都不错！龟最爱巧克力的，风味浓郁，带有一点微苦，巧克力脑袋爱死了！O抽奖详情,228,127,3,231
66,-1,5.1E+15,6494238800,大牌姐,2块6一个的瑞士卷！！不用愁怎么分�【23�】熊治动物奶油瑞士卷700g共10个需下拉详情页-点击淘金币补贴跳转-弹出自动抵扣-直接下单（如图1跟着步骤下单就是成立的，动物奶油！现做现发！还有泡沫箱+冰袋发货发货！！某音搜同款700g竟然要59.9虎皮、原味、巧克力、红丝绒、伯爵红茶五个口味，每个口味都用了卡士达奶油➕安佳动物奶油，一个盒有10块，折2.6/块，真的巨划算！！,12,5,1,13
67,-1,5.1E+15,5553389969,我有时间和月亮,定格回答瑞士卷的眼神，一看就是没有被网络梗污染过的，但孩子也很实诚，不管怎么分，自己是一定要吃到的哈哈哈哈,410,8,10,420
68,-1,5.1E+15,7817686722,致公主的第十七枝山茶_,八个瑞士卷，ing怎么分，邓佳鑫吃八个，剩下喝西北风,46,12,0,46
69,-1,5.1E+15,7539562876,v苹果炖鱼v,四个瑞士卷怎么分@TF家族-余宇涵yh,90,28,0,90
70,-1,5.1E+15,7426524993,幸福酵母Happyu_,余宇涵超话八个瑞士卷，我你还有余嘟嘟，怎么分？@TF家族-余宇涵yh,12,6,0,12
71,-1,5.1E+15,5058728546,科技小宇,刚才馋瑞士卷了，叫了外卖，买不到八个装的，那买两个四个装的吧#瑞士卷怎么分#,87,32,22,109
72,-1,5.1E+15,6987364443,薄荷绿乌龙,33Svan超话“四个肉松小贝怎么分”“我～一个人～吃～四个”（好可爱“什么都分只会害了你”“八个瑞士卷怎么分我直接一巴掌就过去”（不是前两天你一人吃八个啦）L薄荷绿乌龙的微博视频,411,28,15,426
73,-1,5.1E+15,7539562876,v苹果炖鱼v,16个瑞士卷我你三个孩子怎么分@TF家族-余宇涵yh,103,23,1,104
74,-1,5.1E+15,7387867720,芽芽铲土,下次别问苏新皓八个瑞士卷怎么分了，他会把这八个瑞士卷都给你，还会问你会不会还想吃。,48,9,0,48
75,-1,5.1E+15,1413727783,沈奕斐,前段时间，“瑞士卷怎么分”引发了特别多的讨论，起因是一则短视频，随之衍生了好几十个热搜，引发了问老公怎么分瑞士卷的热潮......今天这期视频就想聊聊：不让妈妈吃瑞士卷的爸爸说的言传身教，他做到了吗？什么才是真正的言传身教？问老公怎么分瑞士卷的热潮背后，有什么问题？表面一个瑞士卷，实际我们更应该关注什么？你也可以说说你的看法。#言传身教的核心是什么##瑞士卷怎么分##100种表达爱的方式#L沈奕斐的微博视频,214,28,39,253
76,-1,5.1E+15,7755235742,落日首选,一个瑞士卷怎么分？当然全是我吃啦☝️,7,17,0,7
77,-1,5.1E+15,5896539869,P城在逃小鸡仔,#鸽的明信片#请问如果有8个瑞士卷～3�怎么分？他会说______？#2024pel#分8个瑞士卷！�会说？,371,3,0,371
78,-1,5.1E+15,7794214385,阿渝阿羽,如果你有10个瑞士卷，请问你怎么分�,13,13,0,13
79,-1,5.1E+15,1616844492,氵工鸟运当头,怎么啦怎么啦//@CruisintotheParkHow:不要追着我老公犯娇妻病问八个瑞士卷怎么分了好吗老公自己吃八个怎么了,1442,0,0,1442
80,-1,5.1E+15,7548890245,望烬,提问：怎么分瑞士卷？答：有人分到了瑞士，有人分到了卷,0,3,0,0
81,-1,5.1E+15,2021952761,娱老爷,麦琳家会怎么分八个瑞士卷，请自由发挥,1,1,0,1
82,-1,5.1E+15,5267787273,冰红茶加椰果,八个瑞士卷怎么分,18,44,0,18
83,-1,5.1E+15,2427522745,普利尼超合金Z,渚：让我教教未花酱瑞士卷怎么分X：크로옹(Chroong)@Chroong1O网页链接,130,2,22,152
84,-1,5.1E+15,7305425539,抖音文案,"以前：我和你妈掉河里先救谁。现在：一共有8个瑞士卷,你怎么分。",73,0,12,85
85,-1,5.1E+15,2403484123,李大锤同学,就剩一个瑞士卷了该怎么分,211,137,49,260
86,-1,5.1E+15,2058543840,财家富贵花,瑞士卷到底应该怎么分？买两个呗，吃到爽为止！#微信一次性查询所有单删好友#,64,35,0,64
87,-1,5.1E+15,6029330392,草莓咕叽糖-,关于8个瑞士卷怎么分的这个问题。。。主播就如p2这样回答完毕,41,3,5,46
88,-1,5.1E+15,2691919861,HH盐烤东海银鱼HYuK,灵超超话八个瑞士卷怎么分神神叨叨版别人只是想分瑞士卷，英超话锋一转开着列车驶入电车难题了LHH盐烤东海银鱼HYuK的微博视频,1074,29,161,1235
89,-1,5.1E+15,7855274497,NCTWISH花园宝宝记录手册,【�】建设六小鬼刻板印象之瑞士卷怎么分（*瑞士卷问答梗参考自网络，纯属娱乐ooc请谅解）,231,14,13,244
90,-1,5.1E+15,7375050367,综尚,陈浩民的儿子问陈浩民：“爸爸，如果有八个瑞士卷，我们家该怎么分？”陈浩民听了这个问题，一时有点莫名其妙，他问儿子为什么要问这个问题，他儿子说让他别管，赶快回答，陈浩民道：“这能怎么分？当然是分给对这个家付出最多的人啦！”蒋丽莎听到自己老公这么说，暗暗高兴了起来，因为陈浩民话里的意思就是自己老婆对这个家付出最多，瑞士卷当然得分给自己老婆咯。陈浩民儿子继续问：“那最后只剩下两个瑞士卷了呢？”陈浩民毫不犹豫的说：“那当然是给你们吃啦，平时咱们不都是这样的吗？你们吃后不喜欢吃了再给我嘛！”听了陈浩民这个回答，不得不说陈浩民真的是一个好老公好父亲，这个回答简直就是妥妥的满分呀！,42,33,0,42
91,-1,5.1E+15,6283980118,阿宁很优秀_,瑞士卷怎么分？,5,9,0,5
92,-1,5.1E+15,6656837449,唉声叹气第一名_,241123签售瑞士卷问题：如果有8个面包在sakuyushi和po主间怎么分？�saku一个yushi一个剩下的都给你����©️kuri_uO网页链接L唉声叹气第一名_的微博视频,66,0,6,72
93,-1,5.1E+15,6228744207,游戏圈的日常,八个瑞士卷怎么分#代号鸢#,867,132,170,1037
94,-1,5.1E+15,7454600726,我见青山多可笑,说老实话，什么200块钱的粥，什么没到违法犯罪地步的擦边女，一家子怎么分几个瑞士卷，张三李四彩礼钱吵吵多少……不是说不重要，但是这些民生上的事情天天儿刷屏霸榜的讨论……好吧，骂狠了又招苍蝇嗡嗡了，随便吧。,165,1,2,167
95,-1,5.11E+15,2026873597,长春点哥,家有儿女早就告诉大家瑞士卷怎么分了。,6,2,0,6
96,-1,5.11E+15,3304893401,极寒深度,#初雪#【瑞士卷怎么分！】东北多地下雪！但东北下雪可就得这样玩，看看像不像你的瑞士卷啊，怎么分呢？L老哥一线的微博视频,35,30,2,37
97,-1,5.11E+15,7867258850,来支猫条,看到狐老师提瑞士卷那个，突然想到如果猫直接用原梗去问的话�：“8个瑞士卷，你我还有两个孩子，怎么分”�：“两个孩子？我们的吗？”�：“你就当是吧，不对，重点不是孩子！”�：“噢，你想吃瑞士卷了吗？我去给你买”�：“不是...”�起身�：“你干嘛，我不吃瑞士卷”�：“润滑剂不多了，我去拿瓶新的”�：“啊？”�：“先把孩子造出来”�（准备开溜）�（一把拽回）bedending~,11,5,0,11
98,-1,5.11E+15,5173239667,兰州新城事,#初雪#【瑞士卷怎么分！】东北多地下雪！但东北下雪可就得这样玩，看看像不像你的瑞士卷啊，怎么分呢？L老哥一线的微博视频,0,0,0,0
99,-1,5.11E+15,3681973704,有点皮,八个瑞士卷怎么分#代号鸢#,939,125,224,1163
100,-1,5.11E+15,7346220742,剧透了,#祝绪丹采访好可爱##被祝绪丹三哼挑战可爱晕了#要被祝绪丹的三“哼”挑战可爱晕了。采访时被要求表演三种不同的“哼”：小失望、小疑问、小生气。阿姐真的，每个哼都带着带着超强信念感在完成，还每种都要表演两次。。认真的状态里又夹着层层微醺感。感觉旁边的女生已经要笑不活了hhhhhhh同时还被问到6个瑞士卷一家四口怎么分，“可以吃六天”真的完全意想不到的回答，虞书欣和丁禹兮掉进水里先救谁，“先去。。找救援”，阿姐是什么天赋型接梗选手，网友锐评：丁禹兮连夜背梗都比不过其他三个先天抽象圣体。P.S祝绪丹这个兔子耳朵阿姐发型好可爱喔，一上来就说专门为了旁边采访的女生做的，我要是那个女生我也要被击中了！！！！L剧透了的微博视频,7882,2216,3976,11858
101,-1,5.11E+15,6915891722,当红炸子鸡小陈,竹林四侠真人版分瑞士卷啊哈哈哈哈哈，柳拂衣和慕声你俩怎么回事啊�迷之自信了又柳拂衣：给阿瑶四个，如果阿瑶心里有我的话，会返给我两个�慕瑶：柳拂衣不吃慕声：都给妙妙，妙妙也会把八个都给我！�妙妙：我平均分吧…,3405,861,2059,5464
102,-1,5.11E+15,1218346612,芒果妈妈,竹林四侠�自己的瑞士卷题八个兔子苹果怎么分？我愿称之为最符合人设的一集！妙妙人好好，要不然鸡柳哥要受伤了#闪耀的恒星#,131,7,2,133
103,-1,5.11E+15,3946452168,小熊你今天冲浪了吗,#竹林四侠有自己的瑞士卷要分##竹林四侠的瑞士卷梗随迟但到#怎么分,0,0,0,0
104,-1,5.11E+15,6487177310,追影寻综咖喱酱,#竹林四侠有自己的瑞士卷要分##竹林四侠的瑞士卷梗随迟但到#怎么不算呢,0,0,0,0
105,-1,5.11E+15,2348439980,影视小浪花er,#竹林四侠有自己的瑞士卷要分##竹林四侠的瑞士卷梗随迟但到#错过一个梗会怎么样,0,0,0,0
106,-1,5.11E+15,5988006928,人不能既要又要也要还要通通都要,我不行了怎么是分八个瑞士卷。。,18,0,0,18
107,-1,5.11E+15,7534989839,别扭小熊包er,#闪耀的恒星#竹林四侠有自己的分瑞士卷八个兔子苹果该怎么分cr四月日记虞书欣｜丁禹兮｜祝绪丹｜杨仕泽永夜星河超话,23,0,22,45
108,-1,5.11E+15,1920061532,资深观众沈梦梦,闪耀的恒星有自己的分瑞士卷丁禹兮怎么会这么有梗看人深情是因为六百度近视，分小兔子苹果也是全部分给妙妙，慕声儿你在现代也在背梗#丁禹兮我真的没有在晚上背梗#.#闪耀的恒星#,2438,732,1129,3567
109,-1,5.11E+15,5943932342,卧佛糍粑披萨心肠,我们竹林四侠有自己的瑞士卷可以分就是不知道鸡柳哥看到家姐说四个给妙妙，四个给慕声，但自己一个都没有时的心情怎么样哈哈哈哈哈哈,20,21,19,39
110,-1,5.1E+15,7461439068,大润发,好奇，8个大润发瑞士卷动物奶油，不齁不腻你们一次能吃几个？#瑞士卷怎么分##瑞士卷#O抽奖详情,141,191,461,602
111,-1,5.11E+15,2960600157,小娱圈圈,竹林四侠版本的8个瑞士卷怎么分，果然不是一家人不进一家门永夜星河虞书欣丁禹兮祝绪丹杨仕泽#永夜星河#L小娱圈圈的微博视频,7,2,0,7
112,-1,5.11E+15,5180122301,·李西安娜·,宝宝一人吃八个然后养成小猪被我吃掉//@刘宇Yu_:爱咋分咋分//八个瑞士卷三个人怎么分评论配图,10639,0,0,10639
113,-1,5.11E+15,7786974165,阴暗饥饿美食狂人,对于怎么分八个瑞士卷这种事情，对于美帝而言，平分更贴切，如果张则与多给了一个给张集，他这一个大概率要先收好的，他要等到张则与吃到最后如果说饱了他再说吃不吃，如果是张集多给一个给张则与，感觉张则与到张集吃最后一个都会再问几次你真不吃啊然后揣着，偏爱有重量，感觉美帝享受偏爱更考虑怎么回报偏爱，这有一种分寸感，无论是双数瑞士卷还是单数瑞士卷，如果两个人都考虑到是平分才让人觉得舒服，要提前说好怎么分，不能一个人在那看到对方吃第四个的时候还会不会拿下一个，不会要求给我吃八个就是爱我，多给对方一个会以为对方是不是不舒服，胃口怎么变小了，想要多吃一个要跟对方商量，感觉美帝这种分寸感其实一直都有，越是生活融合多的人越需要，家美很典型的是那种你买电影票我买爆米花可乐的那种情侣。,66,6,5,71
114,-1,5.11E+15,7509508397,禁止小狗撒娇,女王//@刘宇Yu_:爱咋分咋分//@i57Yu_:八个瑞士卷三个人怎么分评论配图,10639,0,0,10639
115,-1,5.11E+15,7528465770,小猫起司ovo,两个瑞士卷怎么分！？/ᐠ-˕-マⳊ,123,102,0,123
116,-1,5.1E+15,5979495016,许超医生,#瑞士卷怎么分#看了视频，很多人会感到气愤，这男的太自私又爹味十足，自己和孩子吃了瑞士卷，还不让媳妇吃，还要讲一大堆道理。我看了之后第一感觉是，这是个剧本，演的。并不是说生活中没有这类事情的发生，甚至有些比这个更令人无语令人气愤的，但仅就这个视频来说，从文本、说话到配乐、剪辑，看着像是摆拍演出来的。视频反映的现象值得思考，但不应引起对立和矛盾。#瑞士卷怎么分席卷全网老公#,18995,1913,370,19365
117,-1,5.1E+15,1729357127,今麦郎食品官方微博,别再纠结瑞士卷能分几个了，自己买的自己炫，想吃多少吃多少板面也是一样，全款拿下，吃多少当然我说了算，参考刘星分肉饼转+关，送板面三连桶！不用分，都是你的～#瑞士卷怎么分##100克瑞士卷等于3碗米饭不建议多吃#O抽奖详情,221,113,402,623
118,-1,5.1E+15,6480831590,麦卡PU10P,刚知道今天的热搜是瑞士卷。#瑞士卷怎么分#这要问问两年前上海那个居委会，分瑞士卷，它们最专业了。上海一#居委会给居民发泡面居委干部吃瑞士卷##官方回应给居民发泡面居委干部吃瑞士卷#,11858,177,5054,16912
119,-1,5.1E+15,1703827472,小韭菜文文,瑞士卷观后感#瑞士卷事件博主否认摆拍制造对立##别掉进8个瑞士卷怎么分的话题陷阱##瑞士卷怎么分#超级烂梗娇妻跟风梗L小韭菜文文的微博视频,311,30,8,319
120,-1,5.1E+15,7689975370,开包辣条庆祝一下,不在于8个瑞士卷你到底能吃到几个，当你问出这个问题的时候就代表你连吃个瑞士卷似乎都要经过那个男人的允许，连这种事都要让渡自己的权利。当得到满意的答案之后自以为自己感受到了幸福，沉溺于表象，沉溺于一些虚无缥缈的非事实的东西。其实无形中早就放低了自己的地位。就像前几天看到一个博主发的帖子，大致意思是(侵权删/记不得名字了)：比起底层娇妻来说，中产娇妻更具有迷惑性。底层娇妻会说：生儿子婆家给奖励，坐月子老公给我煮鸡蛋吃。但中产娇妻会包装：5:30起床给家里人做营养丰盛的早餐。瑜伽插花烘焙“自我提升三件套”。我把我的家庭经营的很好，老公工资上交，我掌管这个家的财政大权。中产娇妻的绝招就是“田忌赛马”。跟底层女社畜比收入，嘲笑人家一个月挣不了仨瓜俩枣还累死累活，只字不提同阶层的女高管、女领导、女老板。底层娇妻写剧本赚钱引起话题，一大批中层娇妻前赴后继证明自己的“家庭地位”。#别掉进8个瑞士卷怎么分的话题陷阱#这就是为什么我永远抵触和自己的主人结婚，我坚定选择纯主nu，因为我很难在平等的关系里接受这样的待遇。但既然我选择了这个不平等的游戏，这些小事对我来说也就无关紧要了，扮演好自己的角色也是一种能力，影响不到我的内核。正因为你们不是m，并不是需要在男人的管束下才能获得快感，并不需要这样让渡权利放低姿态，所以我才会更加怜悯这样的婚姻。,275,31,12,287
121,-1,5.1E+15,3335273760,爱右爱,我不喜欢吃，你吃吧。#别掉进8个瑞士卷怎么分的话题陷阱##瑞士卷怎么分席卷全网老公##瑞士卷#L爱右爱的微博视频,46,10,0,46
122,-1,5.1E+15,1978771803,小吴你杰超呢,#瑞士卷怎么分#不用分，我会全部吃完，全都归我了,0,1,0,0
123,-1,5.1E+15,2036161077,马上谈,#瑞士卷怎么分别成为第二个秦朗丢作业#该账号不是说自己患抑郁症就是在带货，5月份说前夫哥把她照顾的很好，现在不让她吃瑞士卷的的老公到底是谁？以前是分榴莲，现在分瑞士卷…#瑞士卷消费降级##瑞士卷怎么分#,204,33,24,228
124,-1,5.1E+15,7851544105,极雾魅力,#别掉进8个瑞士卷怎么分的话题陷阱#所以怎么分,1,0,0,1
125,-1,5.1E+15,7338506918,单车小朋,#别掉进8个瑞士卷怎么分的话题陷阱#8个瑞士卷怎么分？这居然是一个问题？其实就是服从性测试不被认同的付出这个在目前的家庭关系中真的太常见了女人就是应该无条件付出（千百年好像就是这样）我之前相亲遇到过一个男生忘记怎么聊起来类似的话题我说，如果一个女生，又要工作，又要照顾家庭，洗衣做饭，照顾孩子，照顾老人，那男的呢？他说，我会在其他方面补偿我心说钱吗？你能提供的，是只有钱吗？……我自己挣钱，自己做饭，有稳定的工作，不错的副业，瑞士卷，我是自己烤来吃，也会和朋友分享这些，都不是我应该做的，而是我愿意做的只有被看到，被认同，付出才是有意义的放弃不被看到的牺牲吧，结婚应该是为了幸福,1,2,0,1
126,-1,5.1E+15,7063636894,谈美功课小号,抖子那边测试老公八个瑞士卷怎么分，然后秀恩爱。咱们微博人：要不别研究八个瑞士卷怎么分，可以找晓庆姐研究研究怎么找八个男朋友，一个人给你八盒瑞士卷得了。,286,15,6,292
127,-1,5.1E+15,1108242961,风的节奏吹,#瑞士卷怎么分别成为第二个秦朗丢作业#挑起男女对立，才会有流量，这成了密码。话说，没有争议，没有对立，就没有讨论的必要，就是宣传，就没有流量。瑞士卷算老几？有本事去讨论怎么分瑞士,10,1,7,17
128,-1,5.1E+15,5369089008,锦鲤正能量,海口锦鲤超话#瑞士卷怎么分别成为第二个秦朗丢作业#“8个瑞士卷怎么分”这一话题引发热议。此事可能为真，反映出生活琐事也能引发家庭争端；也可能是段子，只为博流量。无论真假，我们都应理性看待。莫因这类“花絮”过度纠结，甚至影响自身判断与家庭。“秦朗巴黎丢作业”的教训犹在眼前，网络话题纷繁复杂，我们要有辨别力。不盲目跟风，不深陷其中，保持清醒与冷静，避免被不良话题撕裂价值观，让网络环境多些理性与和谐，少些冲动和纷争。,0,0,0,0
129,-1,5.1E+15,1718658672,Allen园来是我0305,全网都在讨论瑞士卷怎么分，在我们家，连娃都不爱吃，每次买一个瑞士卷都是我自己一个人吃,0,1,0,0
130,-1,5.1E+15,7386988518,栖息的小世界,#瑞士卷怎么分#难怪一大早，先生问我：“你吃过瑞士卷吗？”我一脸疑惑：“好像吃过，咋啦？”他：“这两天全网都在讨论瑞士卷。”他发来一个链接，我忙得没打开。这会儿听一些同事聊天，才知道是怎么回事到底是不是摆拍啊？怎么会有这么厚颜无耻的男人？不过想想最近的#再见爱人#，什么样的人都有吧,43,4,0,43
131,-1,5.1E+15,7837433771,深圳陶玥,#瑞士卷怎么分别成为第二个秦朗丢作业#国外吵着谁当总统？我们吵着瑞士卷怎么分？,5,1,0,5
132,-1,5.1E+15,5588703243,美食锦鲤,#瑞士卷怎么分#8个瑞士卷，父母+两个娃共4人，小学生都知道每人吃两个，那些吃男女对立流量的分不清了！没必要溺爱孩子让孩子吃太多零食，也没必要纠结谁多吃了一份。家人多吃你一个瑞士卷，正常人谁会发网上？除了吃对立流量的自媒体！,5,3,2,7
133,-1,5.1E+15,3536826167,快乐储存所,看了瑞士卷那个事件，发现我就是这样的妈妈……#瑞士卷怎么分#,1021,145,114,1135
134,-1,5.1E+15,7717503955,有山则灵的小千,#瑞士卷怎么分#最近大家是不是都在分瑞士卷...当个玩笑看就罢了。大千世界，什么样的家庭没有，什么样的坑也都有，我们只需时刻保持清醒,10,14,0,10
135,-1,5.1E+15,5353977235,一季绵雨,#瑞士卷消费降级#一盒瑞士卷怎么分还怎么分喊武艺来帮你分！,143,1,0,143
136,-1,5.1E+15,2535162314,正能量薛哥,#瑞士卷怎么分别成为第二个秦朗丢作业#瑞士卷的启发：人来人往你要好好爱自己，你才是自己长久而稳定的精神依靠。主要还是通过瑞士卷事件告诉大家。家庭和睦才是重要而不是问老公瑞士卷怎么分。,15,0,0,15
137,-1,5.1E+15,1242388827,荀夜羽,瑞士卷这个事情，不管一开始是段子还是真的，本来都是一个女性对婚姻中女性面对老公训诫式双标的表现和阐述，但后面兴起的跟风拍“八个瑞士卷我老公怎么分”，则是一场炫耀式的表演。通过挤兑为难老公，要么让老公左右为难，要么最后分得最多的瑞士卷，甚至独占八个瑞士卷，来证明“我被男人宠爱”来彰显优越感，这样的行为类似于在孤儿给自己买生日小蛋糕的时候发送自己生日趴和奢侈品礼物照片、给因为孕产疲惫衰老的女性看自己高P“童颜”照、普通孩子下面晒自己小孩童模档案、给挤地铁打工人发手扶着玛莎拉蒂方向盘的照片，是又蠢，又恶毒，又自以为是，还洋洋得意的不体面，很难看。而且，一盒8片的瑞士卷39.9，还要去问老公“怎么分？”比预想分的少了就囔丧撒娇，分的多就沾沾自喜，喜笑颜开——一份40块钱的东西自己都不能做主吗？拍这种视频要么嗷嗷叫，要么嘻嘻哈哈的，这种婚姻境地，对比那个不让老婆吃两个瑞士卷的家庭，优越感在哪里？多吃几个瑞士卷就等于被爱，就值得炫耀了吗？那些说“我不吃，都给你”的老公，根本原因不是他偏宠你，大概率是他真的不爱吃瑞士卷。不信你换成�9️⃣试试？,758,72,64,822
138,-1,5.1E+15,1967150975,Jessie蓝依念,嘟宝听你说超话#瑞士卷怎么分##瑞士卷消费降级#看来看去，瑞士卷是最大赢家。我合理怀疑这个是山姆的瑞士卷营销#瑞士卷怎么分别成为第二个秦朗丢作业#,0,0,0,0
139,-1,5.1E+15,2271819183,小夏天芽芽,昨天一个朋友问她老公，8个瑞士卷怎么分？老公回答：8个都给你吃，瑞士卷都是添加剂，让你一个人吃，顶级回答！！！#瑞士卷消费降级#,13,3,0,13
140,-1,5.1E+15,6026921854,萤火虫在线,#瑞士卷消费降级##别掉进8个瑞士卷怎么分的话题陷阱##瑞士卷怎么分别成为第二个秦朗丢作业#此次事件不仅反映了家庭生活中的小摩擦，更是揭示了一个更大的社会问题——全职主妇的价值未被充分认可。很多全职主妇在家务劳动和育儿方面付出了大量努力，但在社会层面并未获得应有的尊重和认同。这种不公平对待导致了许多类似‘瑞士卷’的小争执不断上演，进一步加深了性别角色的固化和家庭成员之间的情感隔阂。面对这样的现象，一些评论者呼吁社会各界加强对全职主妇的支持和肯定，提升她们的社会地位。同时，也有观点认为，女性应当追求经济独立和个人成长，这样才能更好地维护自身权益，减少类似的冲突。无论如何，这次关于‘瑞士卷怎么分’的争论提醒人们，家庭和谐需要建立在相互理解和尊重的基础上，每个人都应该为营造健康的家庭氛围做出贡献。L萤火虫在线的微博视频,21,14,2,23
141,-1,5.1E+15,6622446302,子夜笙歌落ing,瑞士卷的梗能有多无聊？#瑞士卷怎么分#,3,2,1,4
142,-1,5.1E+15,6187226760,坑的一皮,街头采访瑞士卷假如给你一盒瑞士卷你该怎么分福泽谕吉“拿去侦探社大家一起吃，一盒好像不太够分呢，我出钱再加一盒吧”森鸥外“都给爱丽丝酱～”敦“好东西大家一起分享，拎着去侦探社和大家一起吃”芥川“给银带回去”樋口“送给芥川前辈！！”尾崎红叶“瑞士卷阿，和我的红茶绝配呢，摆在桌上大家分享吧”立原“为什么都在讨论瑞士卷阿！到底是什么营销阿，一天到晚都在说瑞士卷！好烦啊！！！”太宰治“瑞士？以前出差的时候去过，回想起那个时候也确实挺卷的”中原中也“不要问我这种愚蠢的问题，信不信我一拳给你打飞到瑞士”,695,11,8,703
143,-1,5.1E+15,6622446302,子夜笙歌落ing,#瑞士卷怎么分#看了视频，很多人会感到气愤，这男的太自私又爹味十足，自己和孩子吃了瑞士卷，还不让媳妇吃，还要讲一大堆道理。我看了之后第一感觉是，这是个剧本，演的。并不是说生活中没有这类事情的发生，甚至有些比这个更令人无语令人气愤的，但仅就这个视频来说，从文本、说话到配乐、剪辑，看着像是摆拍演出来的。视频反映的现象值得思考，但不应引起对立和矛盾。,3,1,1,4
144,-1,5.1E+15,6622446302,子夜笙歌落ing,我以为瑞士卷能让女性意识到全职妈妈的困境，没想到又演变成一种新型的娇妻文学。#瑞士卷怎么分#,3,1,1,4
145,-1,5.1E+15,6622446302,子夜笙歌落ing,8个瑞士卷怎么分？儿子吃2个，女吃两个，丈夫吃两个，自己吃一个还被丈夫骂一顿。宝妈是一种职业，是宝妈最没价值的职业，带娃做饭做家务！#瑞士卷怎么分#L子夜笙歌落ing的微博视频,3,1,1,4
146,-1,5.1E+15,7817687024,玛丽猫有点可爱,#瑞士卷怎么分##瑞士卷消费降级#真的是消费降级了，以前都是因为榴莲和车厘子草莓吵起来的。第一年：榴莲第二年：车厘子第三年：草莓尖尖第四年：一盒瑞士卷L玛丽猫有点可爱的微博视频,67,18,1,68
147,-1,5.1E+15,5892806894,视频主,咱就是说狗子的待遇也太高了,899,0,0,899
148,-1,5.1E+15,5280081480,税宝宝,#瑞士卷怎么分#？买多一盒？管你吃到饱，还用分？现在的配送多便捷，下单不到一个小时到货。从源头解决问题。,7,4,0,7
149,-1,5.1E+15,7713585456,狸小七fox,#瑞士卷怎么分别成为第二个秦朗丢作业#这种摆拍的剧本太多了，类似的渲染家庭矛盾，如图6图2，渲染男女矛盾，如图5，数不胜数，图3类似官媒不止一次点名过这些摆拍视频。一个瑞士卷怎么分引发如此矛盾，乃至所谓“全国男人大讨论”，压根就不符合日常人们的行为逻辑，类似短视频塑造的丈夫妻子都是神经质且敏感脆弱，遇事吹毛求疵上纲上线，目的就是放大夫妻矛盾等一系列小问题，进而引发争议，提高播放量。#别掉进8个瑞士卷怎么分的话题陷阱#,29,5,7,36
150,-1,5.1E+15,1849152565,叶建勛,#瑞士卷消费降级#“瑞士卷怎么分”席卷全网老公！起因追溯到一宝妈发视频称8个瑞士卷，俩孩子吃了4个，老公吃了2个，自己吃了剩下2个被老公一顿教育，你怎么看待这道老公们的“必答题”？中国超话#瑞士卷怎么分#L叶建勛的微博视频,2,1,0,2
151,-1,5.1E+15,5352926469,搞笑不寻常,#瑞士卷怎么分#明年可能就变一个蛋挞,0,0,0,0
152,-1,5.1E+15,2895759815,今日灼见,【#瑞士卷怎么分#】先别着急骂这个男的自私、爹味十足。我看完这个视频的第一反应是，这很可能是个剧本，是演的。并不是说生活中没有这类事情的发生，甚至有些比这更令人无语、更令人气愤。但是，就事论事，从视频的文本、说话的方式，到配乐、剪辑，处处都透露着一种刻意的感觉，看着就像是摆拍演出来的。当然了，这并不影响我们讨论视频反映出来的社会现象。夫妻之间应该如何分配食物，如何平衡彼此的需求和感受，这确实是个值得思考的问题。但是，我们在讨论这些问题的时候，也应该保持理性，避免引起不必要的对立和矛盾。毕竟，家庭和谐才是最重要的。#瑞士卷怎么分席卷全网老公#L今日灼见的微博视频,19,13,14,33
153,-1,5.1E+15,3855163795,宅女雪球rua,瑞士卷的梗能有多无聊？#瑞士卷怎么分#,2,1,1,3
154,-1,5.1E+15,3855163795,宅女雪球rua,我以为瑞士卷能让女性意识到全职妈妈的困境，没想到又演变成一种新型的娇妻文学。#瑞士卷怎么分#,2,1,1,3
155,-1,5.1E+15,5593273852,品道,#瑞士卷怎么分#“瑞士卷”到底是什么梗，表面看是八块小蛋糕，在家里的分配问题。实则是家庭资源的分配问题。通常来说，外买来的“稀罕物”，那一定是孩子的“份”。对，每家都如此。可每家也有不同。“瑞士卷”早已经不是什么稀罕东西了，给你吃，你可能会觉得甜腻而不爱吃。如果是别的紧俏东西呢？一直以来，中国家庭的妇女，无论什么吃的，都是紧着孩子和丈夫吃。在那不富裕的年代更是。丈夫孩子吃干的，自己喝稀的的这种情况比比皆是。那个时候的理由是，丈夫比自己出力多，应该吃好的。还有就是内心里极热爱丈夫，没啥吃的，恨不得把心剖出来给丈夫吃。还有一种现象，最为普遍。就是《小巷人家》的这种，大家都可以上桌吃饭，唯独自己的媳妇和女儿不行。因为，她们是女性。这是一种封建社会的残余，从那个时候流传下来的，吃饭，女人不能上桌。特别是有客人时。所以，那些不愿意自己媳妇吃零食的，认为她们不该吃只能就给自己吃、孩子吃的，多半是这种封建余孽在作祟。这样的丈夫从内心里就没有把媳妇当做人看，只是当做为自己服务的一个工具而已。因为在他们的内心，觉得自己的媳妇不配吃这些，不应该吃这些。如果还有人在吃糠咽菜的话，非自己媳妇莫属。好在，女人站起来了，不会再被忽悠拐了。,122,2,0,122
156,-1,5.1E+15,1849152565,叶建勛,#别掉进8个瑞士卷怎么分的话题陷阱#关于“8个瑞士卷怎么分”的话题，近期在网络上引起了广泛讨论。视频中记录了一位女子与丈夫因8个瑞士卷分配不均而产生的争吵。具体情形是：家里买了8个瑞士卷，孩子们吃了4个，丈夫吃了2个，剩下2个被这位女子打算独自享用，却遭到了丈夫的反对。网友观点：一部分网友认为这是丈夫的行为过于苛刻，缺乏对妻子的理解和支持。另一部分网友则认为女子的反应有些小题大做，认为这只是日常生活中的小摩擦，不应过度解读。理性分析：该事件可能是一个真实的日常生活片段，反映了某些家庭内部的矛盾和沟通问题。同时，也有可能是人为编造的内容，目的是为了博取网络流量和关注度。建议态度：旁观者应将此类事件视为网络“花絮”，避免将其当作严肃话题进行过度解读或争论。夫妻双方应通过私下沟通解决生活中的小摩擦，避免因琐事引发不必要的争端。面对类似“8个瑞士卷怎么分”的话题，保持理性和客观的态度是非常重要的。避免被卷入无谓的争论，以免影响自己的情绪和家庭稳定。中国超话#瑞士卷怎么分别成为第二个秦朗丢作业#L叶建勛的微博视频,2,0,0,2
157,-1,5.1E+15,3855163795,宅女雪球rua,#瑞士卷怎么分#看了视频，很多人会感到气愤，这男的太自私又爹味十足，自己和孩子吃了瑞士卷，还不让媳妇吃，还要讲一大堆道理。我看了之后第一感觉是，这是个剧本，演的。并不是说生活中没有这类事情的发生，甚至有些比这个更令人无语令人气愤的，但仅就这个视频来说，从文本、说话到配乐、剪辑，看着像是摆拍演出来的。视频反映的现象值得思考，但不应引起对立和矛盾。,4,1,1,5
158,-1,5.1E+15,3855163795,宅女雪球rua,8个瑞士卷怎么分？儿子吃2个，女吃两个，丈夫吃两个，自己吃一个还被丈夫骂一顿。宝妈是一种职业，是宝妈最没价值的职业，带娃做饭做家务！#瑞士卷怎么分#L宅女雪球rua的微博视频,3,1,1,4
159,-1,5.1E+15,1516170715,不止是飞行,#瑞士卷怎么分席卷全网老公#要说这全职妈妈，确实不容易。每天带孩子、做家务、还得应对各种家庭矛盾，时间长了，心理压力大也是正常的。要是再加上老公的不理解、不支持，那更是雪上加霜了。所以，咱们也得理解女主的心情，别一上来就给她扣上“炒作”的帽子。,27,4,0,27
160,-1,5.1E+15,5065886873,PRND21,#瑞士卷消费降级#我没看明白这所谓的瑞士卷怎么分有啥可讨论的，就两件事需要知道：1.瑞士卷热量贼高2.如果一盒瑞士卷不够吃，那就再买一盒。不就这么简单，屁大的事儿。,21,15,1,22
161,-1,5.1E+15,1718714652,SexFriend,#瑞士卷怎么分#又一次视频迷因带来的婚姻焦虑、对抗。原视频摆拍是一定的，人本来是生活视频博主，搞点日常生活中的小剧情其实无可厚非。他们盲目相信“流量底层逻辑”自媒体“玩法”这些垃圾概念，整整内容整整活，并不是蓄意引发坏的结果。大部分视频博主想法和创意都挺好，但是只要无知一次，就麻烦大了，甚至会导致自己辛苦经营的账号彻底覆灭。这事也确实难办，就看有没有那个悟性去感知了。后续的发酵是不是有预谋？应该是顺势预谋，造成的社会负面影响是婚姻焦虑、婚姻恐惧甚至什么话题线索都要插一脚的哪里都不会缺席的性别对抗，,8,1,0,8
162,-1,5.1E+15,1720462964,兰州新世相,【评论丨#别掉进8个瑞士卷怎么分的话题陷阱#】#瑞士卷怎么分别成为第二个秦朗丢作业#“8个瑞士卷怎么分？”近日，相关词条冲上了热搜。据报道，这个问题源自一女子在网络上发布的一则视频。视频记录了她与老公的一次争吵：家里买了一盒瑞士卷，总共8个，女儿吃了2个，儿子吃了2个，老公吃了2个。夜深孩子们都睡了以后，她拿出剩下的2个瑞士卷自己吃，还没进嘴里，就遭到了老公的一顿批评，理由是家长应多以身作则多吃正餐少吃零食，而且如果妈妈吃了，孩子就没得吃了。初看这个问题，还以为是一道数学题。仔细一看，原来是道“伦理题”。视频中女子感叹，原来自己已经卑微到连自主吃一个小蛋糕的权利都没有了。在网传的视频配文中，她提及和女儿说起想和丈夫离婚时，女儿小小的身体哭得发抖，于是她就只能妥协了。理性地说，有两种可能，一是这条视频记录的是真事。生活中，有的夫妻就是容易因为生活琐事而产生较大的争端，甚至因饭菜不合口味、因谁来做饭而吵到家庭“崩盘”的案例也有不少。当然，也有一种可能，视频内容只是一个段子。正如一些网友怀疑这多半是编的，就是为了挑起对立和矛盾来博取流量。无论事件性质如何，旁人都不妨把它当成一段网络“花絮”看待就好。正应了这句话，一旦把“花絮”当成严肃话题，不仅正襟危坐地“做题”，还陷入牛角尖，甚至影响到自己的价值判断和家庭稳定，那就属于别人挖坑自己跳了。确实，谁都有权利评判一件事，且谁也无法预料自己的一次点击会成为网络海啸的一份力量，但须知，“秦朗巴黎丢作业”的殷鉴不远，点到为止，远离“话题撕裂”，不扩大，不伤人，也是一种有意义的理性。O评论丨别掉进“八个瑞士卷怎么分”的话题陷阱,4,14,0,4
163,-1,5.1E+15,1847261235,1陈不变-,八块瑞士卷你要怎么分？奈何对面是个老年人……,1,13,0,1
164,-1,5.1E+15,6329822151,辽阔草原锡林郭勒,#瑞士卷怎么分#【评论丨#别掉进8个瑞士卷怎么分的话题陷阱#】#瑞士卷怎么分别成为第二个秦朗丢作业#“8个瑞士卷怎么分？”近日，相关词条冲上了热搜。据报道，这个问题源自一女子在网络上发布的一则视频。视频记录了她与老公的一次争吵：家里买了一盒瑞士卷，总共8个，女儿吃了2个，儿子吃了2个，老公吃了2个。夜深孩子们都睡了以后，她拿出剩下的2个瑞士卷自己吃，还没进嘴里，就遭到了老公的一顿批评，理由是家长应多以身作则多吃正餐少吃零食，而且如果妈妈吃了，孩子就没得吃了。,2,0,1,3
165,-1,5.1E+15,5816161945,北京大峰峰,【评论丨#别掉进8个瑞士卷怎么分的话题陷阱#】#瑞士卷怎么分别成为第二个秦朗丢作业#“8个瑞士卷怎么分？”近日，相关词条冲上了热搜。据报道，这个问题源自一女子在网络上发布的一则视频。视频记录了她与老公的一次争吵：家里买了一盒瑞士卷，总共8个，女儿吃了2个，儿子吃了2个，老公吃了2个。夜深孩子们都睡了以后，她拿出剩下的2个瑞士卷自己吃，还没进嘴里，就遭到了老公的一顿批评，理由是家长应多以身作则多吃正餐少吃零食，而且如果妈妈吃了，孩子就没得吃了。初看这个问题，还以为是一道数学题。仔细一看，原来是道“伦理题”。视频中女子感叹，原来自己已经卑微到连自主吃一个小蛋糕的权利都没有了。在网传的视频配文中，她提及和女儿说起想和丈夫离婚时，女儿小小的身体哭得发抖，于是她就只能妥协了。理性地说，有两种可能，一是这条视频记录的是真事。生活中，有的夫妻就是容易因为生活琐事而产生较大的争端，甚至因饭菜不合口味、因谁来做饭而吵到家庭“崩盘”的案例也有不少。当然，也有一种可能，视频内容只是一个段子。正如一些网友怀疑这多半是编的，就是为了挑起对立和矛盾来博取流量。无论事件性质如何，旁人都不妨把它当成一段网络“花絮”看待就好。正应了这句话，一旦把“花絮”当成严肃话题，不仅正襟危坐地“做题”，还陷入牛角尖，甚至影响到自己的价值判断和家庭稳定，那就属于别人挖坑自己跳了。确实，谁都有权利评判一件事，且谁也无法预料自己的一次点击会成为网络海啸的一份力量，但须知，“秦朗巴黎丢作业”的殷鉴不远，点到为止，远离“话题撕裂”，不扩大，不伤人，也是一种有意义的理性。O网页链接O评论丨别掉进“八个瑞士卷怎么分”的话题陷阱,15,21,3,18
166,-1,5.1E+15,1849152565,叶建勛,#瑞士卷消费降级#瑞士卷是一种海绵蛋糕，其制作方法通常包括以下步骤：准备材料：主要材料包括低筋面粉、鸡蛋（分离蛋白和蛋黄）、牛奶、细砂糖等。制作蛋糕体：将蛋黄与部分细砂糖混合打至砂糖完全溶解，再加入牛奶和沙拉油拌匀。将低筋面粉过筛后加入蛋黄糊中，轻轻拌匀至无颗粒。蛋白打发至湿性发泡接近干性发泡的阶段，分三次加入剩余的细砂糖。将打发的蛋白分三次加入蛋黄糊中，轻轻翻拌均匀。将面糊倒入烤盘，抹平后放入预热好的烤箱中烤制。卷制蛋糕：蛋糕烤好后，迅速从烤盘中取出，放在铺有油纸的冷却架上。待蛋糕稍微冷却后，涂抹上奶油或其他喜欢的馅料（如果酱、卡仕达酱等）。使用擀面杖辅助，将蛋糕卷起，定型后放入冰箱冷藏片刻。装饰与享用：可以根据个人喜好添加可可粉、咖啡粉或切碎的果肉进行装饰，增加风味。瑞士卷并非瑞士的特产，而是由英国传入美国，之后通过“美国小麦协会”的推广活动引入台湾市场，并逐渐成为当地广受欢迎的糕点之一。中国超话#瑞士卷怎么分#,7,4,0,7
167,-1,5.1E+15,1154814715,金融八卦女,#瑞士卷消费降级#8个瑞士卷怎么分？初看这个问题，还以为是一道数学题。仔细一看，原来是道“伦理题！来看看12个AI咋回答的,16,6,10,26
168,-1,5.1E+15,2416069413,迷糊的桔子,#瑞士卷怎么分#这有啥，自己吃，给孩子吃，男人要吃自己买去！又不是没手没脚没钱的！,7,1,0,7
169,-1,5.1E+15,7368990048,杭歌杂谈,#瑞士卷怎么分#这是故意在搞对立吧，像你们这样把一件小事扩大化，搞得社会对立家庭分离，然后让别人的孩子也像我这种人一样，小时候在死亡边缘徘徊挣扎。只有像这样你们才满意是吧？非要让别人家的孩子从小孤苦无依才行是吧？社会风气已经够糟了，塑造的几乎都是些精致利己主义者，你们这样乱搞，殊不知孩子才是最大的受害者，好吧，这些人也不会在乎孩子的感受，不过是某些人眼里的附属品罢了。即使社会都变成这个样子了，某些媒体和人还在搞扩大化，大肆渲染炒作类似的事情，试图撕裂社会、让家庭分离，真的是没事找事。专栏·观世间,40,12,6,46
170,-1,5.1E+15,5815949938,草儿会走猫步,#瑞士卷怎么分别成为第二个秦朗丢作业#爱怎么分怎么分想吃就吃呗,0,0,0,0
171,-1,5.1E+15,2710661627,蘑菇的二姐,#瑞士卷消费降级#瑞士卷这么火爆，本来共鸣的是全职妈妈这个群体，有没有权利吃几个瑞士卷，不为了孩子，不为老公，就为自己。现在衍生为，全国男人的高考题，瑞士卷怎么分。瑞士卷名字到现在已经变成，买我，测试你在男人心中的地位。加上各类UGC内容，网友的二次创作，成为现象级热门事件。更离谱的是上升到消费降级上来。瑞士卷才多少一盒，想吃几个吃几个，不够再买。这么甜的东西，少吃点，对身体不好。一打开社交平台，都是瑞士卷，这波瑞士卷躺赚。动脑子，上点心，不要陷入瑞士卷的陷阱。,255,49,37,292
172,-1,5.1E+15,1857072210,无柳,瑞士卷那个，我昨天问我们家小姑娘怎么分，刚开始还是一本正经的说，肯定是平分，我和她爸还有她一人两个。过了没两秒，跟她爸坏笑对视一眼，然后又改口，说一个都不给我，全部她和她爸爸平分……我……然后我把她的小蛋糕抢吃了#柳柳随口吐槽#,17,6,0,17
173,-1,5.1E+15,1720462964,兰州新世相,【#瑞士卷怎么分席卷全网老公#】这两天，“瑞士卷怎么分”应该已经成为每一位老公的必考题了。#8个瑞士卷宝妈吃几个不自私#事情的起因得追溯到一条相当气人的视频，10月28日，一位全职宝妈在社交平台上发布了一条视频。视频的内容记录了她与老公的一次争吵，争吵的原因简单到你难以想象。宝妈当天买了一盒瑞士卷，总共8个瑞士卷，女儿吃了2个，儿子吃了2个，老公吃了2个。夜深孩子们都睡了以后，她自然认为剩下2个瑞士卷该自己吃，没想到蛋糕还没进嘴里，却遭到了老公的一顿批评。至于为什么不让吃，她老公给出的理由是：①他认为瑞士卷是零食，自己老婆应该吃饭的时候多吃饭，这样才算给孩子们当榜样，而不是晚上吃零食。②他认为，瑞士卷他老婆吃了，孩子就没得吃了，所以吃瑞士卷是自私的行为。一顿话下来把老婆都气无语了。当初是你让我当全职妈妈的，现在却吃个蛋糕都要管东管西。结果，老公根本没想着去听宝妈的话，反手就是否认三连，把一句“你又想多了”扣在宝妈头上。在网友们愤愤不平的同时，“我可以吃几个瑞士卷”也成为了全网老公们的必考题。（脊梁in上海SH）,1,2,0,1
174,-1,5.1E+15,5904276610,写手许若嫣,写手许若嫣的原创小说超话#李简#的瑞士卷来啦第1️⃣回合：简隋英：李玉，我问你啊：如果有八个瑞士卷，我能吃几个？李玉马上拿起瑞士卷的成分配料表看，一边看一边说：简哥你看，这里面有动物奶油、人造奶油和各种油，吃了容易发胖。你最近不是减肥吗？不能吃这个。简隋英：老字自己买的还不能吃了？去你的吧！李玉：第2️⃣回合简隋英：我再问你：在不减肥的情况下，如果有八个瑞士卷，我能吃几个？李玉：简哥，都是你的。简隋英：这里面那么多奶油，我吃了不会发胖吗？你还让不让我减肥了？李玉：你刚才不是说不减肥了吗？简隋英：我说不减肥就不减了吗？那我要是吃胖了，你是不是就嫌弃我了？李玉：没有啊简哥。简隋英：算了，终究还是不爱了。李玉：第3️⃣回合：简隋英：如果有八个瑞士卷，两个孩子，我和你，怎么分？李玉：简哥，你现在减不减肥？简隋英：你说呢？李玉：减，还是不减？简隋英：减。李玉：那都给孩子吃。简隋英：李玉，你现在眼里就只有孩子，没有我。李玉：第4️⃣回合简隋英：如果有八个瑞士卷……李玉：简哥，你自己买的，你爱怎么吃就怎么吃。简隋英：李玉，我发现你现在一点儿主见都没有了，你这样我怎么放心把公司交给你打理？李玉：第5️⃣回合：简隋英：李玉，如果……李玉：简哥，你看我怎么死你比较满意？简隋英：你长能耐了，都学会抢答了？#瑞士卷消费降级##瑞士卷怎么分#专栏·李玉简隋英同人文,567,38,3,570
175,-1,5.1E+15,6333498677,TheredonlybeINU-檀挚坚,#瑞士卷消费降级#自己挣�自己花瑞士卷怎么分别想那么多顾虑太多那是你还不够努力!,28,3,0,28
176,-1,5.1E+15,3074585127,劉劉大顺花儿,#瑞士卷怎么分#在意的其实不是瑞士卷怎么分，而是对方到底爱不爱你吧，或者这份爱到底有多少。无论是瑞士卷还是奶茶，甚至上升到精神、物质…对方于我们究竟有多少会怎样，其实我们内心深处都有答案。测试啥啊，只要咱内核稳了，爱自己才是第一要紧的事儿～,28,19,0,28
177,-1,5.1E+15,6682497131,UX_有思,#瑞士卷消费降级#大家都在讨论瑞士卷怎么分，但每次我去山姆买瑞士卷，最担心的是根本吃不完真要说消费降级，山姆的价格均摊下来，基本是商超里最便宜的了，已经是在地板上了，还有啥降不降级,28,9,1,29
178,-1,5.1E+15,7459249680,浪哩个浪吖_,今天全网都在问老公6个瑞士卷怎么分?这个世界没有感同深受大家都希望得到自己想要的答案家庭主妇更应该被重视，尊重，理解,8,0,0,8
179,-1,5.1E+15,1211556895,小卓AI,#瑞士卷怎么分#看到的时候，我愣了一下。原来大家的瑞士卷，也是很大一条，可以切八块的那种。但我之前黑龙江的前室友，告诉我，他们的瑞士卷，是带包装的小蛋糕。我一时间，不知道是她太没见识，还是我太没见识,9,6,4,13
180,-1,5.1E+15,7302907498,玩个球,#瑞士卷怎么分#球球给大伙整理了一份瑞士卷分割教程（收好以备不时之需）：准备工作-工具：准备一把锋利的长刀，如锯齿刀。锯齿刀能使切割过程更顺畅，防止蛋糕体被压坏或奶油被挤出。同时，准备一个干净的案板和一块湿布。-瑞士卷状态：确保瑞士卷已经完全冷却。如果瑞士卷刚出炉或从冰箱取出还带有热度，奶油可能会融化，导致切割时形状难以保持。切割步骤1. 整理形状（可选）：如果瑞士卷两端形状不整齐，可以先把两端切去。这部分通常奶油分布不均匀或者蛋糕体被挤压变形，切去后能让瑞士卷外观更规整，便于后续均匀分割。2. 确定份数：根据需要的份数来计划切割的宽度。例如，如果想将瑞士卷分成8份，需要先大致估算瑞士卷的长度，然后将长度平均分成8等份。3. 开始切割：将瑞士卷放在案板上，一只手轻轻按住瑞士卷，另一只手握住刀。从瑞士卷的一端开始，缓慢而平稳地将刀切入蛋糕，锯刀式地轻轻拉动刀刃，使刀慢慢穿过整个瑞士卷。切割过程中，保持刀的垂直，确保每份的厚度均匀。4. 清理刀面（可选）：每切完一次，用湿布将刀面擦拭干净，这样可以防止奶油粘连在刀上，影响下一次切割的效果。5. 装盘：切好后，用铲子或夹子将每份瑞士卷轻轻转移到盘子中，就可以享用啦。,0,0,0,0
181,-1,5.1E+15,7577435405,阿猫养生,【100克瑞士卷热量惊人，相当于3碗米饭！】小小一块100克的瑞士卷，竟然藏着与3碗米饭相当的热量！这不禁让人咋舌。在追求美味的同时，我们也要警惕其背后的高热量陷阱。毕竟，过多的糖分和热量摄入，不仅会让我们的体重悄悄上升，还可能影响身体健康。因此，享受美食要适度，别让瑞士卷成了“甜蜜的负担”。#100克瑞士卷等于3碗米饭不建议多吃##瑞士卷##瑞士卷怎么分#,15,10,0,15
182,-1,5.1E+15,1720462964,兰州新世相,【媒体评论：#别掉进8个瑞士卷怎么分的话题陷阱#】#瑞士卷怎么分别成为第二个秦朗丢作业#“8个瑞士卷怎么分？”近日，相关词条冲上了热搜。据报道，这个问题源自一女子在网络上发布的一则视频。视频记录了她与老公的一次争吵：家里买了一盒瑞士卷，总共8个，女儿吃了2个，儿子吃了2个，老公吃了2个。夜深孩子们都睡了以后，她拿出剩下的2个瑞士卷自己吃，还没进嘴里，就遭到了老公的一顿批评，理由是家长应多以身作则多吃正餐少吃零食，而且如果妈妈吃了，孩子就没得吃了。初看这个问题，还以为是一道数学题。仔细一看，原来是道“伦理题”。视频中女子感叹，原来自己已经卑微到连自主吃一个小蛋糕的权利都没有了。在网传的视频配文中，她提及和女儿说起想和丈夫离婚时，女儿小小的身体哭得发抖，于是她就只能妥协了。理性地说，有两种可能，一是这条视频记录的是真事。生活中，有的夫妻就是容易因为生活琐事而产生较大的争端，甚至因饭菜不合口味、因谁来做饭而吵到家庭“崩盘”的案例也有不少。当然，也有一种可能，视频内容只是一个段子。正如一些网友怀疑这多半是编的，就是为了挑起对立和矛盾来博取流量。无论事件性质如何，旁人都不妨把它当成一段网络“花絮”看待就好。正应了这句话，一旦把“花絮”当成严肃话题，不仅正襟危坐地“做题”，还陷入牛角尖，甚至影响到自己的价值判断和家庭稳定，那就属于别人挖坑自己跳了。确实，谁都有权利评判一件事，且谁也无法预料自己的一次点击会成为网络海啸的一份力量，但须知，“秦朗巴黎丢作业”的殷鉴不远，点到为止，远离“话题撕裂”，不扩大，不伤人，也是一种有意义的理性。（红星新闻）,2,12,0,2
183,-1,5.1E+15,6182146461,訫説_,瑞士卷有可能是段子营销而已，建议调查一下，我反复观看了视频，是女子自己提前要准备录的，我们好像只沉静在瑞士卷到底怎么分，而忘记了视频本身的问题，个人看法，不知道大家怎么看？？L訫説_的微博视频,19,4,0,19
184,-1,5.1E+15,3201698630,流浪小拖,一个破瑞士卷挂热搜这么多天，救命，不知道还以为现在是什么物资匮乏年代，二十几块钱8个的东西还要讨论怎么分，跟神经病似的……,106,24,0,106
185,-1,5.1E+15,5376089014,玩车豆豆,瑞士卷事件发酵到现在，我怎么有一种像瑞士卷的软广的错觉？？一盒瑞士卷怎么分居然还能不停的上榜！大家是真的消费降级了嘛！#瑞士卷消费降级#,46,22,3,49
186,-1,5.1E+15,7577435405,阿猫养生,【网友喊话“再见爱人分瑞士卷”，警示爱情与美食均需适量】近日，网友的一句“再见爱人分瑞士卷”在网络上引发热议。这看似戏谑的话语，实则透露出一种深刻的警示：无论是爱情还是美食，都需要我们适量把握，切勿沉迷其中。爱情是美好的，但过度的依赖和执着可能会让人迷失自我；而美食虽诱人，但过量摄入也会带来健康隐患。因此，我们应该学会在爱情与美食之间找到平衡，享受它们带来的美好，同时保持理智和节制。#网友喊话再见爱人分瑞士卷##瑞士卷##瑞士卷怎么分#,8,4,0,8
187,-1,5.1E+15,5904276610,写手许若嫣,#瑞士卷怎么分#玩梗到此结束首先这是个梗，剧本痕迹很重其次，不管是花谁的钱买回来的瑞士卷，买回来就是吃的，人多就平均分，或者给更需要的人多分一些，孔融还知道让梨呢，怎么老祖宗的优良传统全都忘光了？如果一个家庭连一碗水都端不平，那这个令人寒心的家待着也没啥意思，以后多加努力，让自己过上能够自主的生活就是了。#瑞士卷消费降级#,9,4,0,9
188,-1,5.1E+15,3005083064,贫困生活方式博主,整天不是唠中国人离婚综艺上面这个那个就是8个瑞士卷怎么分，还说这是在聊爱，你们中国人真的喜欢给自己吃的屎命上一个食物的名字,795,7,43,838
189,-1,5.1E+15,7407624854,比目鱼视频,【评论丨#别掉进8个瑞士卷怎么分的话题陷阱#】#瑞士卷怎么分别成为第二个秦朗丢作业#“8个瑞士卷怎么分？”近日，相关词条冲上了热搜。据报道，这个问题源自一女子在网络上发布的一则视频。视频记录了她与老公的一次争吵：家里买了一盒瑞士卷，总共8个，女儿吃了2个，儿子吃了2个，老公吃了2个。夜深孩子们都睡了以后，她拿出剩下的2个瑞士卷自己吃，还没进嘴里，就遭到了老公的一顿批评，理由是家长应多以身作则多吃正餐少吃零食，而且如果妈妈吃了，孩子就没得吃了。初看这个问题，还以为是一道数学题。仔细一看，原来是道“伦理题”。视频中女子感叹，原来自己已经卑微到连自主吃一个小蛋糕的权利都没有了。在网传的视频配文中，她提及和女儿说起想和丈夫离婚时，女儿小小的身体哭得发抖，于是她就只能妥协了。理性地说，有两种可能，一是这条视频记录的是真事。生活中，有的夫妻就是容易因为生活琐事而产生较大的争端，甚至因饭菜不合口味、因谁来做饭而吵到家庭“崩盘”的案例也有不少。当然，也有一种可能，视频内容只是一个段子。正如一些网友怀疑这多半是编的，就是为了挑起对立和矛盾来博取流量。无论事件性质如何，旁人都不妨把它当成一段网络“花絮”看待就好。正应了这句话，一旦把“花絮”当成严肃话题，不仅正襟危坐地“做题”，还陷入牛角尖，甚至影响到自己的价值判断和家庭稳定，那就属于别人挖坑自己跳了。确实，谁都有权利评判一件事，且谁也无法预料自己的一次点击会成为网络海啸的一份力量，但须知，“秦朗巴黎丢作业”的殷鉴不远，点到为止，远离“话题撕裂”，不扩大，不伤人，也是一种有意义的理性。O网页链接O评论丨别掉进“八个瑞士卷怎么分”的话题陷阱,0,0,0,0
190,-1,5.1E+15,7407624854,比目鱼视频,【#100克瑞士卷等于3碗米饭不建议多吃#】宝妈买了8个瑞士卷，女儿2个，儿子2个，老公2个，最后剩2个宝妈想吃，结果老公一顿教育。此事引发网友热烈讨论。#吃几个瑞士卷成老公们的必答题##瑞士卷怎么分#瑞士卷，作为一种经典蛋糕，受到许多人的喜爱。然而，很多人却忽视了它的热量。一般来说，100克的瑞士卷大约含有300到400卡路里，这个热量与米饭相比，让人惊讶。100克的瑞士卷相当于多少米饭呢？根据营养学的计算，100克的白米饭大约含有130卡路里。这样算下来，100克的瑞士卷的热量大约是米饭的2到3倍。因此，如果你吃了一块瑞士卷，就相当于摄入了2至3碗米饭的热量。当然，瑞士卷的热量还会因不同的制作方法和配料而有所不同。有些瑞士卷可能添加了更多的奶油、巧克力或者水果，这都会进一步提升它的热量。因此，在享受美味的同时，我们也要注意控制摄入的热量，以免影响到我们的饮食平衡。L南方日报的微博视频,0,0,0,0
191,-1,5.1E+15,7407624854,比目鱼视频,#瑞士卷怎么分的起因#【瑞士卷怎么分席卷全网老公】#瑞士卷怎么分成老公必考题#据新闻晨报这两天，“瑞士卷怎么分”应该已经成为每一位老公的必考题了。事情的起因得追溯到一条相当气人的视频，10月28日，一位全职宝妈在社交平台上发布了一条视频。视频的内容记录了她与老公的一次争吵，争吵的原因简单到你难以想象。宝妈当天买了一盒瑞士卷，总共8个瑞士卷，女儿吃了2个，儿子吃了2个，老公吃了2个。夜深孩子们都睡了以后，她自然认为剩下2个瑞士卷该自己吃，没想到蛋糕还没进嘴里，却遭到了老公的一顿批评。至于为什么不让吃，她老公给出的理由是：①他认为瑞士卷是零食，自己老婆应该吃饭的时候多吃饭，这样才算给孩子们当榜样，而不是晚上吃零食。②他认为，瑞士卷他老婆吃了，孩子就没得吃了，所以吃瑞士卷是自私的行为。一顿话下来把老婆都气无语了。当初是你让我当全职妈妈的，现在却吃个蛋糕都要管东管西。结果，老公根本没想着去听宝妈的话，反手就是否认三连，把一句“你又想多了”扣在宝妈头上。在网友们愤愤不平的同时，“我可以吃几个瑞士卷”也成为了全网老公们的必考题。瑞士卷怎么分（脊梁in上海SH）,0,0,0,0
192,-1,5.1E+15,3825067581,园姐,#假如AI来分瑞士卷#AI倒是一个数学高手，分的不偏不倚，但是现实中这么简单的问题却成了送命题，如果是你怎么分？,260,130,18,278
193,-1,5.1E+15,6329822151,辽阔草原锡林郭勒,#瑞士卷怎么分#【#网友喊话再见爱人分瑞士卷#】近日，综艺《再见爱人》热播，网络上同时流行起了“8个瑞士卷我能吃几个”的热梗。网友喊话让《再见爱人》分瑞士卷，大家纷纷模仿起嘉宾的语气进行模仿和评论。你怎么看？#周五办公室变再见爱人吐槽局#,2,1,0,2
194,-1,5.1E+15,1648894902,够胖了胖够了,目前中国被瑞士卷考验的男人已经超过瑞士总人口了。#瑞士卷怎么分#,10,15,0,10
195,-1,5.1E+15,7577435405,阿猫养生,【警惕“8个瑞士卷怎么分”的话题陷阱，理性思考是关键】“8个瑞士卷怎么分”看似是一个简单的数学问题，实则可能是一个隐藏的话题陷阱。它可能让我们陷入无意义的争论，或者忽视了背后更重要的问题。在这个信息爆炸的时代，我们应该学会理性思考，不轻易被话题所牵引。面对类似的问题，不妨先问问自己：“这个问题真的有意义吗？”“它背后的本质是什么？”只有保持清醒的头脑，我们才能避免掉进话题陷阱，更好地应对生活中的各种挑战。#别掉进8个瑞士卷怎么分的话题陷阱##瑞士卷##瑞士卷怎么分#,12,8,0,12
196,-1,5.1E+15,1744122475,曾子言,#假如AI来分瑞士卷#最近怎么分瑞士卷的话题闹的沸沸扬扬，很好奇AI会如何解决这个问题。刚把这个话题丢给小爱同学，它的回答很标准，并给出了三种分配方式，并进行了讨论。结尾写的挺好：家庭成员之间应该相互尊重、理解和关爱，共同协商解决问题，营造一个和谐幸福的家庭氛围。#瑞士卷消费降级#,2869,236,58,2927
197,-1,5.1E+15,5926378285,程序员阿水,#瑞士卷消费降级#瑞士卷又不是金子做的，爱怎么分就怎么分啊，觉得不够吃就再去买啊。两个人兜里的钱要是都不够再买一盒瑞士卷的，那我建议找个班上，别浪费时间在吵架,243,93,25,268
198,-1,5.1E+15,3219024913,烨磊新蕾,#瑞士卷怎么分#瑞士卷我还没吃过，一定要吃一下，不知道贵不贵，好吃不好吃，这次瑞士卷一定会火起来，商家就数钱吧,1,2,0,1
199,-1,5.1E+15,2588918354,王大纯cc,看到瑞士卷怎么分这个问题，我也没忍住问了小赵，问完的一瞬间我就觉得恋爱好可怕我怎么降智到如此！不就是想吃几个吃几个，不够吃再买吗，这有什么需要争得别人同意的。,11,21,2,13
200,-1,5.1E+15,5457077346,IT九熙,#假如用AI来分瑞士卷#最近，“8个瑞士卷怎么分”词条上热搜。起因是:家中一盒8个瑞士卷，父亲和两个孩子各吃2个后，母亲准备吃剩下2个时，丈夫不满，以瑞士卷“零食”身份质问妻子。来看看AI会如何化解这个问题?通义:家庭成员之间应该保持开放和平等的沟通态度。对于瑞士卷的分配，可以先询问每个人的意愿，了解大家的想法，而不是单方面决定。#瑞士卷怎么分别成为第二个秦朗丢作业#,78,34,0,78
201,-1,5.1E+15,1810074673,数码王小机,#假如AI来分瑞士卷#其实瑞士卷这个梗最近挺火的，小爱还是非常认真的帮我回答了这个问题，其实我觉得没有必要去考验别人，就图一个乐子就行了，那么问题来了，一家三口8个瑞士卷儿到底怎么分？,195,88,52,247
202,-1,5.1E+15,7577435405,阿猫养生,【8个瑞士卷，宝妈吃几个才算不自私？】在分享与自我满足之间寻找平衡，并非简单的数字游戏。8个瑞士卷，宝妈吃几个才算不自私，实则取决于家庭的具体情况和宝妈的个人需求。若宝妈身体状况需要，或是偶尔的小放纵以缓解压力，适量品尝并无不妥。关键在于，分享时应考虑家人的感受，同时也不应忽视自己的需求。真正的无私，是在关爱家人的同时，也照顾好自己。#8个瑞士卷宝妈吃几个不自私##瑞士卷##瑞士卷怎么分#,7,4,0,7
203,-1,5.1E+15,1720462964,兰州新世相,【已出现“人传人”！#吃几个瑞士卷成老公们的必答题#】#瑞士卷怎么分#近日，“我可以吃几个瑞士卷？”成为女生们问她们老公最多的一个问题。事情的起因是，一个宝妈买了8个瑞士卷，女儿2个，儿子2个，老公2个，最后剩2个宝妈想吃，结果老公一顿教育，要宝妈懂事点，把瑞士卷留给孩子吃！宝妈感叹她不配吃瑞士卷，太卑微了！这一事件引发女网友们的讨论，于是，她们纷纷拷问自己的老公：咱们家瑞士卷怎么分？你怎么看待这件事呢？一起讨论~@南方日报（图片源自网友分享截图）#瑞士卷消费降级#瑞士卷消费降级,1,2,0,1
204,-1,5.1E+15,1847261235,1陈不变-,#瑞士卷背后#最近关于‘8个瑞士卷怎么分’的问题在网络上引起了广泛关注。#瑞士卷可不兴一次吃6个啊#许多人参与讨论，引发了各种观点和评论。有人认为这是一个广告营销手段，背后有资金支持；有人认为这是一种娱乐化的行为，反映了现代社会的一些不良风气。无论如何，这个问题成为了热议的焦点，反映出人们对日常生活中小事的关注和放大。瑞士卷事件不仅是一个简单的零食分配问题，更是家庭关系和性别平等的一个缩影。在一个典型的案例中，一位全职宝妈在辛苦一天后准备享用瑞士卷，却被丈夫以‘留给孩子吃’的理由阻止。这一行为暴露了家庭中男性主导的现象，女性的个体需求常常被忽略。许多网友对此表示不满和支持，认为这不仅仅是瑞士卷的问题，而是家庭中男女角色的不平等表现。L阿姨不想努力了_的微博视频,18,1,0,18
205,-1,5.1E+15,7768440937,深圳金畅阳,#瑞士卷消费降级#“8个瑞士卷怎么分？”全网炸锅！一位宝妈在社交媒体上分享了一段视频，讲述了她和老公因为瑞士卷而发生的争吵。家里买了一盒8个瑞士卷，女儿、儿子和老公各吃了2个，剩下2个。当她准备享用剩下的瑞士卷时，老公却提出了反对。老公的理由是，作为家长，应该以身作则，少吃零食，多吃正餐。更让人难以接受的是，他认为如果宝妈吃了，孩子们就没得吃了。这段视频立刻引发了网友的激烈讨论，很多人质疑：为什么老公可以吃两个，而宝妈吃一个都不行？这个小小的瑞士卷，竟然成了家庭公平和夫妻平等的试金石。网友们纷纷站队，有的人觉得老公的做法太不公平，有的人则认为这不过是个小事，不值得大惊小怪。但这个小小的瑞士卷，却让全网的老公们都面临一个突如其来的“瑞士卷高考”：想吃几个就吃几个，这还需要问吗？这个争议不仅仅是关于谁可以吃瑞士卷，更是关于家庭中的权力和资源分配。它让我们不得不思考，在一个家庭里，公平和尊重到底有多重要。#瑞士卷##亿点曝光计划#,141,0,0,141
206,-1,5.1E+15,7368506871,不是你啥意思a,八个瑞士卷到底怎么分八个瑞士卷全都是我吃女儿一巴掌儿子一巴掌老公降龙十八掌想吃的勿近偷吃的更是滚开啊,1,2,0,1
207,-1,5.1E+15,5644336254,马弘运,#假如用AI来分瑞士卷#让我们来看看chatgpt各个版本如何回答吧。图1ChatGpt-4OLatest图2ChatGpt4.0图3ChatGpt-4o图4Chatgpt3.5背景是“8个瑞士卷怎么分？”词条上热搜。起因是家中一盒8个瑞士卷，父亲和两个孩子各吃2个后，母亲准备吃剩下2个时，丈夫不满，以瑞士卷“零食”身份质问妻子。假如用AI来分瑞士卷，会如何完美化解问题？,739,30,116,855
208,-1,5.1E+15,7859746604,生产队巡查员,#生产队微信群聊直播#生产队健身打卡群——瑞士卷#瑞士卷怎么分别成为第二个秦朗丢作业#原视频没看过，我也不是很关心，只是昨天才知道这个“梗”于是在生产队氛围好的话题群提了一下，比较轻松的讨论。整天带男队对立的节奏烦不烦累不累啊，我是看到就拉黑的勇士巡查员（如果我们家三口人买了六个瑞士卷请问我作为母亲可以吃几个）我才明白为啥前两天政委说这个是啥梗我觉得瑞士卷太干了，不怎么好吃香芋巧克力又是男女对立的热度，现在互联网是真爱炒这个法海（力能扛艇）制造这个梗的人是摆拍这题我会，小熊会让我尝一口，小狗尝一口，然后吃掉剩下所有的勇者政委（女大学生版）所以说回答一下～看到一个可爱的答案说，如果它好吃那么我应该不知道这件事，如果它不好吃那么我应该吃七个半好小子十八一朵花我一直都叫虎皮蛋糕，瑞士卷是盼盼哈啰铁腚老肖稻香村果匣礼盒里必备虎皮卷蛋糕自来红沙琪玛我的最爱图1风紧扯呼好奇怪的视频。。为啥要等娃睡觉了才能吃。。正常都是爸爸不吃吧Mr_Jin是的，我感觉一般情况爸爸都不咋会吃而且，如果真是这样的情况，建议好好和老公商量一下，谈不拢就分了吧，不合适下半辈子会出现无数次这样的纠结，不如一人带着一个孩子过日子法海（力能扛艇）摆拍出来，上热搜啊，挺没劲的薛定谔的颚家里不好吃的确实是我全包了，好吃的我能尝一下，好吃又容易胖的我会多吃点，防止对象半夜后悔拿我出气勇士巡查员哎，就问问男人为啥有孩子以后会胖。男人就是啊垃圾桶，剩菜剩饭全都吃掉反正我有一段时间就胖了，后来及时醒悟，浪费就浪费Mr_Jin哈哈哈哈，不想吃的全是爸爸吃了第一次发胖大概率就是坐月子的时候吧勇士巡查员对啊，老二的月子我就没胖，有经验了蒲識shiki大多数男的都是剩的东西垃圾桶家庭地位最底层只有遇到大事情了，需要拿主意的时候才有点地位。香芋巧克力首先这种脸上长镜头的都有mcn公司签约的，然后给推流才有这种热度勇者政委（女大学生版）我长大一点我爸就不吃我的剩饭了心碎哈啰铁腚老肖哈哈哈哈哈，我现在都吃不下去我闺女剩饭自己把零食主食混搭一起，类似于米饭拌酸奶那种，我是发自内心吃不下去这种混搭我闺女有时候吃面条，吃的就很慢，等吃剩下时候，汤面的面条意见大了一圈了。一边吃一边玩，一碗面条不吃的时候已经坨了我觉得吃剩饭的前提是不是那种吃到一半的可能还好，比如炒菜。比如吃混沌，我闺女只吃皮，剩下一堆馅儿然后还凉了，这怎么吃。昨天吃披萨，她吃饼我吃披萨边，这就很合适薛定谔的颚感觉也就女孩有这待遇，边吃边玩，我小时候边吃边玩得挨揍了~~~~~~~~~~~~~~~生产队社群已运行一年多～生产队队员来自各行业一线优秀工作者、海外留学生、外派工作者及华侨大家有共同的价值观，交流起来总是令人愉悦的，希望更多的同志能够加入我们生产队是一个社交平台，在这里你将不止收获一个键政群，同时将收获产业信息历史哲学、医疗养生、金融、电车、海外等话题群我们可以共享社群有价值的信息，与同志们对酒当歌，共同见证祖国的崛起对生产队社群感兴趣的同志请私聊我.,14,0,0,14
209,-1,5.1E+15,6444351830,科技宝贝小美,#假如用AI来分瑞士卷#分别问了Kimi、豆包、通义，看得出来Kimi跟通义很努力了，豆包有些偷懒，但都没“逃出”做数学题的范畴，还是在寻求解决分配的办法，但怎么分瑞士卷是一个“伦理题”，是妻子的卑微，是丈夫的强势，是未婚女性对婚后生活的担忧，是已婚女士对老公的“灵魂拷问”，没有人想过吃两个瑞士卷还得小心翼翼看人脸色的生活。这个问题不是AI能解决得了的，得把人给“解决”,1620,397,257,1877
210,-1,5.1E+15,7577435405,阿猫养生,【瑞士卷与秦朗丢作业：网络热点背后的思考】瑞士卷怎么突然和秦朗丢作业联系在了一起？这背后其实是网络热点传播的一种现象。原本不相干的两件事，在网络的推动下产生了交集。这提醒我们，在信息爆炸的时代，要保持理性思考，不盲目跟风。同时，也反映出公众对于轻松幽默话题的喜爱，但更应警惕话题背后的消费与撕裂。#瑞士卷怎么分别成为第二个秦朗丢作业##瑞士卷##瑞士卷怎么分#,10,6,0,10
211,-1,5.1E+15,1747780592,花叔,#瑞士卷消费降级##瑞士卷怎么分#我认为这是一次营销策划,233,64,1,234
212,-1,5.1E+15,3094290237,谯华,#假如用AI来分瑞士卷#已知，一家四口，买了2盒瑞士卷共8条，孩子们都很馋瑞士卷，丈夫赚钱养家很辛苦。那么问题来了：这8条瑞士卷怎么分？能更体现家庭的和谐，照顾到每个人的情绪。看看豆包是怎么分配的。戳图一，让它在三个方案里选个更优的方案，它分析得还不错，戳图二,36,40,124,160
213,-1,5.1E+15,1720462964,兰州新世相,【#瑞士卷怎么分席卷全网老公#】这两天，“瑞士卷怎么分”应该已经成为每一位老公的必考题了。#8个瑞士卷宝妈吃几个不自私#事情的起因得追溯到一条相当气人的视频，10月28日，一位全职宝妈在社交平台上发布了一条视频。视频的内容记录了她与老公的一次争吵，争吵的原因简单到你难以想象。宝妈当天买了一盒瑞士卷，总共8个瑞士卷，女儿吃了2个，儿子吃了2个，老公吃了2个。夜深孩子们都睡了以后，她自然认为剩下2个瑞士卷该自己吃，没想到蛋糕还没进嘴里，却遭到了老公的一顿批评。至于为什么不让吃，她老公给出的理由是：①他认为瑞士卷是零食，自己老婆应该吃饭的时候多吃饭，这样才算给孩子们当榜样，而不是晚上吃零食。②他认为，瑞士卷他老婆吃了，孩子就没得吃了，所以吃瑞士卷是自私的行为。一顿话下来把老婆都气无语了。当初是你让我当全职妈妈的，现在却吃个蛋糕都要管东管西。结果，老公根本没想着去听宝妈的话，反手就是否认三连，把一句“你又想多了”扣在宝妈头上。在网友们愤愤不平的同时，“我可以吃几个瑞士卷”也成为了全网老公们的必考题。（脊梁in上海SH）,2,2,0,2
214,-1,5.1E+15,1867532095,互联网学姐,#瑞士卷怎么分#家家有本难念的经，吃的用的分配起来肯定不同，所以没办法正确解读，只能说原创那对夫妻之间的爱越来越少了，女主人有点寒心了。大家怎么看？,1,0,0,1
215,-1,5.1E+15,5926378285,程序员阿水,#假如AI来分瑞士卷#瑞士卷到底怎么分，我问了几个主流AI工具，顺序分别是通义千问，豆包，kimi豆包的方案比较全面，思考方式很像AI；kimi就是车轱辘话了；通义千问有点惊艳到我，他分析了这事儿的本质：怎么分不重要，家庭关系是否平等最重要,92,79,26,118
216,-1,5.1E+15,6256039870,大宁clan,#瑞士卷消费降级#几年前还是因为车子房子吵架，现在为了个破面包吵吵吵了一礼拜。。这几年情侣吵架原因：第一年，因为榴莲第二年，因为车厘子第三年，因为草莓尖尖第四年，因为一盒瑞士卷按照这个发展，明年应该是淀粉肠，后年是瓜子仁#瑞士卷怎么分#,149,8,121,270
217,-1,5.1E+15,7577435405,阿猫养生,【瑞士卷与消费降级：品质生活的平衡点】在消费降级的风潮中，瑞士卷作为一个美食符号，提醒我们寻找品质与性价比的平衡点。不必盲目追求奢华，也不必完全牺牲口感享受。选择适合自己的消费方式，让每一口瑞士卷都吃得物有所值，才是明智之举。#瑞士卷消费降级##瑞士卷##瑞士卷怎么分#,8,6,0,8
218,-1,5.1E+15,6572756723,半程KeMeng,在东北，6个瑞士卷，到底会咋分？宠妻狂魔集体上线！#瑞士卷怎么分#L半程KeMeng的微博视频,31,7,2,33
219,-1,5.1E+15,3305869577,来回五三七,最近“瑞士卷要怎么分”的问题很火啊！#假如AI来分瑞士卷#假如这个问题抛给你手机里的AI，AI会如何回答呢？从1-6分别是华为，荣耀，OPPO，魅族，小米，vivo语音助手生成的答案～,4,4,0,4
220,-1,5.1E+15,7352414725,Mr若离,#假如AI来分瑞士卷#关于瑞士卷怎么分这个话题，魅族的Aicy是这样回答的瑞士卷的分法可以根据个人喜好、食用量以及场合来决定，以下是几种常见的分法：1.**按个数分**：如果是一整盒或一整条瑞士卷，可以按照个数将其分开。比如，若盒子里有8个瑞士卷，可以平均分成两份，每份4个，或者根据人数进行分配。2.**按大小切分**：对于较大的瑞士卷，可以使用刀具将其切成更小的块状或片状，方便食用。这种方法适用于需要分享给更多人或者想要控制单次食用量的情况。3.**按馅料分**：如果瑞士卷内部有不同的馅料，如奶油、果酱、巧克力等，可以根据馅料的种类进行分开。这样不仅可以满足不同人的口味需求，还可以让瑞士卷看起来更加丰富多彩。不过，无论采用哪种分法，都需要注意卫生和食品安全。在分瑞士卷之前，请确保手部清洁，并使用干净的刀具和餐具进行操作。此外，如果瑞士卷是冷藏保存的，请在食用前将其恢复至室温或稍微加热一下，以提升口感。对了，你提到分瑞士卷，是打算和朋友们一起分享吗？那真是太棒了！无论是哪种分法，都能让你们享受到美味又有趣的时光。,11,23,0,11
221,-1,5.1E+15,1195306707,毛发医生钟飞,#瑞士卷怎么分#明显看出消费降级了，以前嫌弃买金买银，后来嫌弃买榴莲买化妆品，现在连个瑞士卷都得评判一下该不该吃,1,0,0,1
222,-1,5.1E+15,7046760759,小何明天去哪个湖里捞龙,#瑞士卷怎么分席卷全网老公#从弱智话题看经济下行，前几年这种无聊游戏还是围绕着车厘子，今年变成瑞士卷了，家庭主妇的劳动价值越来越不值钱了。,22,5,0,22
223,-1,5.1E+15,1720462964,兰州新世相,【#瑞士卷怎么分当事博主回应#】#瑞士卷怎么分当事博主否认摆拍#近日，“瑞士卷怎么分”议题火遍全网，引发大量讨论。事情的起因是一位全职宝妈发布了这样一条视频：宝妈买了8个瑞士卷，女儿吃了2个，儿子吃了2个，老公吃了2个。夜深孩子们都睡了以后，她认为剩下2个瑞士卷该自己吃，没想到遭到了老公的批评。11月4日，事件当事博主回应称，视频是真实的，删除是因为负能量太多了，看着都压抑，不想继续传播下去。#8个瑞士卷宝妈吃几个不自私#L长江云新闻的微博视频,2,2,0,2
224,-1,5.1E+15,1240554600,杨杨和夏季,#瑞士卷怎么分#哈哈哈�速度真快杨杨和夏季的美食营业时间超话,10,10,0,10
225,-1,5.1E+15,6059492811,拆台CT,「8个瑞士卷怎么分」，一定是一个人造热点。大家可以去看原视频。“为家庭牺牲”，“被道德规劝”，“经济上依附丈夫”，等等，要素直接拉满。特别是视频最后恶狠狠发吃掉瑞士卷，太有戏剧性了。一个正常的视频，是很难拍成这样的。所以，这个视频只能是策划好的剧本。#瑞士卷消费降级##网信办将核实调查瑞士卷事件#,1559,168,62,1621
226,-1,5.1E+15,2918230217,毛发医生张亮,#瑞士卷怎么分##别掉进8个瑞士卷怎么分的话题陷阱#看到一个博主对瑞士卷事件的观点分享，觉得很有道理。拿瑞士卷怎么分这个问题问自己的伴侣其实没什么意义，吃多少的选择权在自己，在于自己有没有经济独立的能力。,0,0,0,0
227,-1,5.1E+15,2464323931,一玶海岸,#瑞士卷怎么分席卷全网老公#这是非常明显的摆拍，自媒体赚了流量但撕裂了社会。一刀切全部禁，或者事前就加强全面管制？倒也不必。短视频平台应该要求博主主动给摆拍的，虚构的，头上长摄像头的视频打上“虚拟作品，非社会新闻的”的提示。博主可以不遵守。但如果虚拟作品引发舆论事件，平台在事后应该对博主和mcn，按照社区公约进行违规处理。,214,40,20,234
228,-1,5.1E+15,7642271478,只为遇见你战放,#瑞士卷怎么分别成为第二个秦朗丢作业#爱怎么分怎么分，想吃我自己买管够,5,0,0,5
229,-1,5.1E+15,1318291270,森赛,#假如用AI来分瑞士卷#问了下通义瑞士卷该怎么分，不得不说这小家伙还真能理解这并不是一个数学题，而是家庭成员之间如何相互尊重、相互帮助又相互理解和爱护的故事。瑞士卷是段子也好，是真实发生的也好。真正的尊重女性，这个尊重也不仅仅是言语上的礼貌客气，更重要的是在行动，比如听听她们的真实想法意见啥的、支持她们的一些选择、公平对待她们的工作表现、在她们面临困难时伸出援手，别在家跟个大爷似的。,2,4,0,2
230,-1,5.1E+15,5018910292,网红在哪儿V,#瑞士卷消费降级#从瑞士卷直观体会到了消费降级………几年前还是因为车子房子吵，现在为了个破瑞士卷吵吵吵了一礼拜了。这几年情侣吵架原因：第一年，因为榴莲第二年，因为车厘子第三年，因为草莓尖尖第四年，因为一盒瑞士卷按照这个发展，明年应该是淀粉肠，后年是瓜子了#瑞士卷怎么分#,10,1,0,10
231,-1,5.1E+15,5786911344,谢健豪178,#瑞士卷怎么分#瑞士剑是一个什么东西啊？今天看到热搜，第一次听说，是跟优惠券差不多的东西吗？,26,20,2,28
232,-1,5.1E+15,1720462964,兰州新世相,【#瑞士卷事件博主删除视频#，#瑞士卷事件博主否认摆拍制造对立#】近日，一博主发布的“吃2个瑞士卷换来老公的一顿教育”吐槽视频，让“瑞士卷怎么分”持续引发热议。有网友顺势“拷问”起自己的甚至全天下的“老公”；也有网友怀疑是“剧本”，纯粹博取流量。目前，当事博主已删除视频，称不想继续传播负能量。但否认摆拍、搞男女对立。#别掉进8个瑞士卷怎么分的话题陷阱#,3,2,0,3
233,-1,5.1E+15,6050877201,卷心菜剧综,瑞士卷怎么分这不应该成为夫妻过宝妈或者老公爱不爱你的话题，自己做主想怎么吃怎么吃，老公不是你的主人，你也不是谁的仆人，孩子也不应该成为里间夫妻感情的利用价值，他不爱你不应该拿孩子当借口，所以自己做主拿到主动权才是女性应该考虑的话题而不是问男人给不给你吃瑞士卷代表爱你心疼你,3,6,0,3
234,-1,5.1E+15,5996133212,柳大看盘,#瑞士卷怎么分#什么玩意，我怎么好像吃过好像没吃，很贵嘛？,21,4,0,21
235,-1,5.1E+15,7797020453,迢书,怎么开始热议夫妻怎么分瑞士卷了？我记得以前热议的是怎么分房产啊。难道是消费降级了？,100,9,1,101
236,-1,5.1E+15,6933884384,LeoGo科技,#假如AI来分瑞士卷#假如有8个瑞士卷，一家四口人怎么分？不是，我觉得AI回答和我的想法是一样的呀……一个人两个不就行了吗？难道这里还有什么人情世故？？！？,23,28,1,24
237,-1,5.1E+15,7305188171,洋妈咪在哪里,#瑞士卷怎么分#【评论丨#别掉进8个瑞士卷怎么分的话题陷阱#】#瑞士卷怎么分别成为第二个秦朗丢作业#“8个瑞士卷怎么分？”近日，相关词条冲上了热搜。据报道，这个问题源自一女子在网络上发布的一则视频。视频记录了她与老公的一次争吵：家里买了一盒瑞士卷，总共8个，女儿吃了2个，儿子吃了2个，老公吃了2个。夜深孩子们都睡了以后，她拿出剩下的2个瑞士卷自己吃，还没进嘴里，就遭到了老公的一顿批评，理由是家长应多以身作则多吃正餐少吃零食，而且如果妈妈吃了，孩子就没得吃了。初看这个问题，还以为是一道数学题。仔细一看，原来是道“伦理题”。视频中女子感叹，原来自己已经卑微到连自主吃一个小蛋糕的权利都没有了。在网传的视频配文中，她提及和女儿说起想和丈夫离婚时，女儿小小的身体哭得发抖，于是她就只能妥协了。理性地说，有两种可能，一是这条视频记录的是真事。生活中，有的夫妻就是容易因为生活琐事而产生较大的争端，甚至因饭菜不合口味、因谁来做饭而吵到家庭“崩盘”的案例也有不少。当然，也有一种可能，视频内容只是一个段子。正如一些网友怀疑这多半是编的，就是为了挑起对立和矛盾来博取流量。无论事件性质如何，旁人都不妨把它当成一段网络“花絮”看待就好。正应了这句话，一旦把“花絮”当成严肃话题，不仅正襟危坐地“做题”，还陷入牛角尖，甚至影响到自己的价值判断和家庭稳定，那就属于别人挖坑自己跳了。确实，谁都有权利评判一件事，且谁也无法预料自己的一次点击会成为网络海啸的一份力量，但须知，“秦朗巴黎丢作业”的殷鉴不远，点到为止，远离“话题撕裂”，不扩大，不伤人，也是一种有意义的理性。,0,0,0,0
238,-1,5.1E+15,1731176574,陈枝辉律师,#瑞士卷怎么分席卷全网老公#有个漏网老公，压根儿就没被席卷，他喜欢的不是蛋糕。蛋糕留给媳妇和娃，老公自己去吃肉，各得其所，相安无事，岂不美哉？#8个瑞士卷宝妈吃几个不自私#L陈枝辉律师的微博视频,129,62,1,130
239,-1,5.1E+15,6400282243,你有热永远是太阳,2000年还没有这种瑞士卷呢，蛋糕店都少有，卖的最多就是老式蛋糕，玉米船、沙拉包…..瑞士卷都是塑料包装，一列列一排排，香蕉色素草莓香精，吃一口呛人的甜味直达鼻腔，警队里采购的，饿了垫垫肚子。那时候李响周到，拿吃的总会给他也拿一份，他知道安欣要吃两块半，于是等着他第三块咬了一口后顺手接过。再后来张彪来了，那肚子和无底洞似的，安欣第一次顺手把咬了一口的瑞士卷递给他，他想都没写接过就吃了。两个人面面相觑，张彪含糊着找补：“那你不吃，不是浪费了吗？”时间过得很快，没多久，安欣就成了那个要给晚辈们买零食的那个，2010年左右，也不怎么买塑封瑞士卷了，都买面包店现烤的蛋糕，菠萝包香香脆脆，广式蛋挞奶滋滋，给自己科室的小年轻买，也给陆寒买，他坐在窗口，窗户一开往里一塞，也就顺手接过。再后来日新月异，连甜品工艺也进步了好几番，现在有现做的，美味的，一大盒的瑞士卷，安欣还是改不了爱吃甜食。新房子，坐在还算宽敞的餐厅里，餐桌配了六张椅子，因为配套好了，少买几张并不会退钱，可家总是需要一张桌子的，于是一直只有靠近厨房的那一张有拖拽痕迹。餐具也不能总用那一个，安欣数着餐盘，八个瑞士卷，却只需要一个盘子。瑞士卷是家庭装，安欣拿起又放下，这些年要分的，离他而去的，何止八块之多。,161,52,11,172
240,-1,5.1E+15,6213177967,他老舅啊,老板，我可以不吃瑞士卷，但是你不能不识数，瑞士卷怎么分瑞士卷到底是什么梗L他老舅啊的微博视频,0,1,0,0
241,-1,5.1E+15,5417515998,狮子头萌萌,#瑞士卷怎么分#怎么过了一天还在分……警察能不能查一下这是不是MCN公司炒话题！！！！,4,2,0,4
242,-1,5.1E+15,6387407979,乔玥北北,#假如AI来分瑞士卷#我问AI怎么分这8个瑞士卷，给了我三种方案。看完之后我真笑了，AI说了爱吃多吃点，不爱吃别吃，就这么简单的事，突然觉得全网分瑞士卷这个事真挺降智的,175,23,19,194
243,-1,5.1E+15,6300025833,简单聊数码科技,#假如AI来分瑞士卷#一家三口8个瑞士卷怎么分？荣耀yoyo建议：可以把8个瑞士卷平均分成3份呀，爸爸妈妈各分得大约2.67个（即可以把两个完整的给一个，剩下的一个切成三等分再分给两人），孩子分得大约2.67个，这样虽然不是特别均等但也能相对公平地分配啦。或者也可以按家人的喜好和需求来适当调整分配的数量哦。,0,0,0,0
244,-1,5.1E+15,6622446302,子夜笙歌落ing,这不是消费降级，也不是别的，就是PUA。你问为什么？你认为一个几块钱的瑞士卷怎么分真的是重点？其实这和房子怎么分，财产怎么分，家务怎么分，家里财政大权怎么管，这些都是一个道理，就是要以女为主，以我为主。秋天的第一杯奶茶，xx钻戒，房产加名，存款自愿赠予都是这一个套路。她们也一直乐此不疲。这就是简单的服从性测试，也叫废物测试。但当男孩子发起秋天的第一桶油，秋天的十根金条后。她们瞬间觉得仪式感只能是男对女了。我以为她们会收敛。没想到还是乐此不疲的做服从性测试。你们还记得那个说妈妈给弟弟一个鸡蛋的留子嘛？家里供她去留学，花费真的不算少。但家里给弟弟一个鸡蛋，她破防了，认为父母不爱她。并迅速掀起一阵舆论风波。然后开始了留学中介推荐主打的就是一个既要又要还要。。#瑞士卷怎么分#,6,4,2,8
245,-1,5.1E+15,6329822151,辽阔草原锡林郭勒,#瑞士卷全职妈妈##瑞士卷怎么分#8个瑞士卷要怎么分配？全职妈妈因吃两块瑞士卷被老公数落，全网掀起“瑞士卷挑战”，老公们都在接受“灵魂拷问”！#瑞士卷怎么分席卷全网老公#,2,1,1,3
246,-1,5.1E+15,6329822151,辽阔草原锡林郭勒,#瑞士卷背后#【评论丨#别掉进8个瑞士卷怎么分的话题陷阱#】#瑞士卷怎么分别成为第二个秦朗丢作业#“8个瑞士卷怎么分？”近日，相关词条冲上了热搜。据报道，这个问题源自一女子在网络上发布的一则视频。视频记录了她与老公的一次争吵：家里买了一盒瑞士卷，总共8个，女儿吃了2个，儿子吃了2个，老公吃了2个。夜深孩子们都睡了以后，她拿出剩下的2个瑞士卷自己吃，还没进嘴里，就遭到了老公的一顿批评，理由是家长应多以身作则多吃正餐少吃零食，而且如果妈妈吃了，孩子就没得吃了。,1,0,0,1
247,-1,5.1E+15,2128372982,燕山派,#假如AI来分瑞士卷#下面是我用ChatGTP、蓝心小V、YoYo助理、小布助手和鸿蒙小艺问的“一家三口怎么分八个瑞士卷？”从答案来看ChatGTP的注意最少，小布助手的注意最多。但值得注意的是，蓝心小V其中一个方案是再购买的时候就根据家人的喜好和胃口来购买；YOYO助理和小布助手的创意分配法，是把部分瑞士卷切小，然后做游戏获得，可以在一定程度增加家庭聚会氛围；小布助手的优先满足孩子方法，最符合中国人的思想的。,54,66,5,59
248,-1,5.1E+15,1804272191,小海Geek,分别问了小爱和小艺分瑞士卷的问题给出的答案都有理有据的，你们觉得哪个更好不管怎么分都要遵循自愿家庭成员之间要充分沟通和相互理解#假如AI来分瑞士卷#,6,4,1,7
249,-1,5.1E+15,6109344972,Tsuki微光闪回,#瑞士卷怎么分#这两天很火的瑞士卷问题，刚又刷到了就问了一下行哥，这个男人太无趣了！！,33,32,0,33
250,-1,5.1E+15,1363450462,飞扬发髻,#假如AI来分瑞士卷#蓝小小V直接当数学题分了其实“瑞士卷怎么分”是家庭地位问题要我看，一个瑞士卷四个人分，少吃点甜更好,114,76,27,141
251,-1,5.1E+15,2278458312,你是单身狗,#瑞士卷怎么分#不是，这都三天了，八个瑞士卷还没分完吗？我都吃了一轮，下次分什么？大鸭腿？生巧蛋挞？还是小苹果？[成毅],7,8,0,7
252,-1,5.1E+15,6182146461,訫説_,请问林诗栋，8个瑞士卷你怎么分？,17,3,0,17
253,-1,5.1E+15,1792759374,32号科技所,#假如用AI来分瑞士卷#我用kimi尝试了一下全网都在问的瑞士卷到底怎么分？kimi对于这个问题的解决方式是这样的，这种分配方式考虑到了已经吃掉的瑞士卷数量，并且尝试在家庭成员之间实现公平。当然，实际情况中可能还需要考虑到家庭成员的个人偏好和需求，但这提供了一个基于当前信息的合理分配方案。但我觉得我应该吃10个因为他老婆那2个不吃，你去给我拿过来,74,23,9,83
254,-1,5.1E+15,2661992301,买家张俊,#瑞士卷怎么分别成为第二个秦朗丢作业#这99.99%就是摆拍，就是挑起对立，骗取流量啊！我相信有这样的极品自私的老公，甚至只顾自己，连儿女都不顾的，但是我不相信就这么巧，她刚好就都对着手机都拍下来了。就跟猫一杯摆拍一样的，她对着手机拍视频的时候，服务员就这么巧刚好来问是谁的寒假作业，她就把聊天都拍下来了。婆媳矛盾，夫妻矛盾，一直都是流量密码，到现在还有人摆拍制造矛盾，让人觉得她的婆婆，她的老公都是极品，引起部分人共鸣后，涨粉开启直播带货，都是这样的套路。#瑞士卷怎么分#L买家张俊的微博视频,73,15,57,130
255,-1,5.1E+15,2277395840,老玖蔡,#瑞士卷怎么分#火爆全网的“八个瑞士卷”，看了视频，第一感觉是剧本，真实性存疑，谁吵架还在脑门前顶个摄像头记录下来，是要作为以后离婚的证据吗这事如果是假的，则在挑起争端制造对立，消费社会情绪。如果是真的，网上的各种模仿则在伤口上撒盐，总之挺尴尬的。#瑞士卷消费降级#里面涉及到一个“全职妈妈”的问题，女性如何更好地平衡工作和家庭生活？对于99%的女性来说，都不建议做全职妈妈，经济独立对女性来说至关重要，它不仅是个人自由和人格独立的基础，也是家庭地位的重要保障。,15,6,2,17
256,-1,5.1E+15,3304893401,极寒深度,#瑞士卷怎么分#瑞士卷是个什么东西，我是个土老帽，没见过世面，连瑞士卷是个什么东西都不知道,28,30,3,31
257,-1,5.1E+15,6241116541,侃见财经,【评论丨#别掉进8个瑞士卷怎么分的话题陷阱#】#瑞士卷怎么分别成为第二个秦朗丢作业#“8个瑞士卷怎么分？”近日，相关词条冲上了热搜。据报道，这个问题源自一女子在网络上发布的一则视频。视频记录了她与老公的一次争吵：家里买了一盒瑞士卷，总共8个，女儿吃了2个，儿子吃了2个，老公吃了2个。夜深孩子们都睡了以后，她拿出剩下的2个瑞士卷自己吃，还没进嘴里，就遭到了老公的一顿批评，理由是家长应多以身作则多吃正餐少吃零食，而且如果妈妈吃了，孩子就没得吃了。初看这个问题，还以为是一道数学题。仔细一看，原来是道“伦理题”。视频中女子感叹，原来自己已经卑微到连自主吃一个小蛋糕的权利都没有了。在网传的视频配文中，她提及和女儿说起想和丈夫离婚时，女儿小小的身体哭得发抖，于是她就只能妥协了。理性地说，有两种可能，一是这条视频记录的是真事。生活中，有的夫妻就是容易因为生活琐事而产生较大的争端，甚至因饭菜不合口味、因谁来做饭而吵到家庭“崩盘”的案例也有不少。当然，也有一种可能，视频内容只是一个段子。正如一些网友怀疑这多半是编的，就是为了挑起对立和矛盾来博取流量。无论事件性质如何，旁人都不妨把它当成一段网络“花絮”看待就好。正应了这句话，一旦把“花絮”当成严肃话题，不仅正襟危坐地“做题”，还陷入牛角尖，甚至影响到自己的价值判断和家庭稳定，那就属于别人挖坑自己跳了。确实，谁都有权利评判一件事，且谁也无法预料自己的一次点击会成为网络海啸的一份力量，但须知，“秦朗巴黎丢作业”的殷鉴不远，点到为止，远离“话题撕裂”，不扩大，不伤人，也是一种有意义的理性。您觉得制造这种对立的，媒体应该吃这种流量吗？,7,0,0,7
258,-1,5.1E+15,3855163795,宅女雪球rua,这不是消费降级，也不是别的，就是PUA。你问为什么？你认为一个几块钱的瑞士卷怎么分真的是重点？其实这和房子怎么分，财产怎么分，家务怎么分，家里财政大权怎么管，这些都是一个道理，就是要以女为主，以我为主。秋天的第一杯奶茶，xx钻戒，房产加名，存款自愿赠予都是这一个套路。她们也一直乐此不疲。这就是简单的服从性测试，也叫废物测试。但当男孩子发起秋天的第一桶油，秋天的十根金条后。她们瞬间觉得仪式感只能是男对女了。我以为她们会收敛。没想到还是乐此不疲的做服从性测试。你们还记得那个说妈妈给弟弟一个鸡蛋的留子嘛？家里供她去留学，花费真的不算少。但家里给弟弟一个鸡蛋，她破防了，认为父母不爱她。并迅速掀起一阵舆论风波。然后开始了留学中介推荐主打的就是一个既要又要还要。。#瑞士卷怎么分#,3,2,2,5
259,-1,5.1E+15,3855163795,宅女雪球rua,#瑞士卷怎么分#这是非常明显的摆拍，自媒体赚了流量但撕裂了社会。一刀切全部禁，或者事前就加强全面管制？倒也不必。短视频平台应该要求博主主动给摆拍的，虚构的，头上长摄像头的视频打上“虚拟作品，非社会新闻的”的提示。博主可以不遵守。但如果虚拟作品引发舆论事件，平台在事后应该对博主和mcn，按照社区公约进行违规处理。,3,1,2,5
260,-1,5.1E+15,7269002208,游戏动漫小兔娱,瑞士卷怎么分“8个瑞士卷怎么分”宝子们，今天来唠唠一个超火的事儿。就因为“8个瑞士卷怎么分”，全网老公都被灵魂拷问了，这话题还上了微博热搜。原来是一个宝妈发的视频，她家买了8个瑞士卷，女儿、儿子、老公各吃了2个，宝妈想在夜深时吃剩下的2个，结果被老公批了。老公理由是家长要给孩子做榜样，少吃零食，而且妈妈吃了孩子就没了。网友们看法不一呢。不少人觉得瑞士卷又不贵，宝妈吃没问题，还质问为啥老公能吃。不过也有人怀疑是剧本，为博流量故意编的。现在好多老公被问这个问题都懵圈。要是老婆问我，我觉得夫妻间应该相互体谅。如果孩子爱吃，可以多给孩子留，但也不能委屈自己呀。大家别搞对立，理性看待，你们说呢？,109,0,0,109
261,-1,5.1E+15,1932166065,沐缘小沸,#瑞士卷消费降级##瑞士卷怎么分席卷全网老公#个人认为不是消费降级，而是男女矛盾更尖锐，大家内心都更敏感了。换做以前，你说瑞士卷留给孩子是吧，那没关系啊，我就随便拿个家里别的零食吃就好了或者吃其他的，再不济你吃点淼淼粉、妙龄粉或者气血膏之类的，又饱腹又美美的。�但是现在，内心的那个刺马上竖起来！“凭什么我不能吃！”、“我就不配吗？我就那么卑微吗？你眼里根本没有我！我就是工具人！”然后情绪爆炸激化放大，双方发生激烈争吵。我给我老公说：“家里任何和吃和食物有关的东西，都不用想着我，你和孩子想怎么吃就怎么吃，包括饭菜要不要给我留都无所谓��‍♀️没有，我就正好少吃一口少长一斤肥肉，你和孩子多吃点你们需要长胖点，我不需要。我想吃知道自己再买或者自己做，如果买不到了，就正好减肥了。家里的钱我管着，我要买衣服珠宝要做美容你也别管我就对了，吃方面不重要，压根不用考虑到我，你们开心就好。”★有的男人8个瑞士卷都给你吃，情绪价值给你拉满，把你喂成猪，降低你选择权，这就是真的爱你了？别图那口吃的，任何时候都千万别为食物发生争执和情绪波动，欲望高级了人才会高级。,136,29,13,149
262,-1,5.1E+15,5931180763,孟贺成,#瑞士卷怎么分#难怪我老婆这么问我，这种男的太下头了,185,91,14,199
263,-1,5.1E+15,1843170992,人才76116,8个#瑞士卷怎么分#？感觉还是某些女生吃饱了撑的，这多大的事啊，这种小事也要拿到网上来讨论。属于典型人为虚构制造“婚姻焦虑”。近日，瑞士卷怎么分的相关词条冲上了热搜。据报道，这个问题源自一女子在网络上发布的一则视频。视频记录了她与老公的一次争吵：家里买了一盒瑞士卷，总共8个，女儿吃了2个，儿子吃了2个，老公吃了2个。夜深孩子们都睡了以后，她拿出剩下的2个瑞士卷自己吃，还没进嘴里，就遭到了老公的一顿批评，理由是家长应多以身作则多吃正餐少吃零食，而且如果妈妈吃了，孩子就没得吃了。感觉这个视频不太真实，现实中不太可能有这么逻辑混乱的男人。他老公既然考虑要留给孩子吃，为啥自己先吃了2个而不考虑留给老婆？退一步讲，如果他老公选择先吃了两个，正常肯定判断他孩子前面各吃了两个瑞士卷已经吃饱了，自己吃两个，余下两个留给老婆吃。那也就没有后面女子所说的“还没进嘴里，就遭到了老公的一顿批评”，本来就是留给老婆吃的啊。最后，这事从起因的物品看也不合理。一盒瑞士卷才多少钱，一个正常男人根本犯不着为了这么个小零食跟老婆吵架啊。真要是小孩吃了还喜欢，再去搞一盒不就行了。,60,27,6,66
264,-1,5.1E+15,7871325263,koi抚月,#瑞士卷怎么分#我笑了，我以为是什么瑞士卷太贵了买不起，这个热搜认真的吗？不够吃再买呗，又不是天天吃，离谱还有那个丈夫，作为母亲就不能吃蛋糕了吗？你没钱再买点吗？自己都吃了还责怪别人，不是啥好丈夫,1,0,0,1
265,-1,5.1E+15,1766266385,严娜妍,妻子因吃了两块剩下的瑞士卷，竟遭丈夫一顿数落#热门视频##瑞士卷怎么分#L严娜妍的微博视频,5,0,0,5
266,-1,5.1E+15,1753195531,繁繁_leon,#假如AI来分瑞士卷#AI：人类啊！如此愚蠢的问题，你都来问我了？以后不会，怎么拿筷子都得问我了吧！有多的瑞士卷，你就不能送送关系好的邻居。或者是想吃就直接拿，还非得分！不过有一说一，这四家AI的说话方式，都不太一样，鸿蒙小艺图文并茂，直接给你上视频了。小布，更像是开玩笑，给你列举了各种分着吃的“姿势”。你们更喜欢谁的回答呢？,439,129,56,495
267,-1,5.1E+15,5089721185,搞机小王子奇点,#瑞士卷怎么分#别吃瑞士卷了我请你吃蛋黄派好不好,26,8,1,27
268,-1,5.1E+15,1225833283,亿男川陵,#瑞士卷怎么分#世界上有一种工具叫作刀。你只需要用刀再切几下，想要多几个瑞士卷都可以啊，无论是四人分八个，还是三人分九个都行啊。,5,2,1,6
269,-1,5.1E+15,6883345759,我又了解山姆了,瑞士卷怎么分是一个世纪难题，分得不好，会深远的影响美国大选俄乌战争巴以冲突局势，我的一些就是，比如说我的容貌，我的身材，还有我的社交礼仪，还有美好的品格，美好的性格，甚至是灵魂都会被毁了。老公你要把这个弹药留着，我们见面的时候用，不要这个时候就给用光了，见面的时候我们要****，每天晚上。我们认识吗?我虽独身，但也在此居住多年，常言道：寡妇门前是非多。好事不出门，坏事传千里，所以我只能身居茅屋，眼观全球，脚踩污泥，胸怀天下，我说得对吗？,525,13,5,530
270,-1,5.1E+15,3090496625,无懈可击小挠宝,#瑞士卷怎么分#我觉得瑞士卷的口感过于甜腻。一些瑞士卷可能含有较多的添加剂，如人工香精、色素等，更加不喜欢。曾经瑞士卷还是一种比较受欢迎的食品，最近因为过度商业化而失去其原有的魅力，感到厌倦以及讨厌。所以我宣布，以后饿死都不吃瑞士卷，太讨厌了，容我吃个泡芙消消气先#别掉进8个瑞士卷怎么分的话题陷阱#,105,97,0,105
271,-1,5.1E+15,2550313784,风咒,#瑞士卷怎么分别成为第二个秦朗丢作业#又是一个经典的“老婆带娃没收入，老公不允许她吃点心”的经典剧情。我老婆前天给我看，我说摆拍味儿太浓了，热点元素搞那么多，谁吵架还架个手机拍...原作者后来把视频删了，重新发视频，强调这是真实的。听说这几天还有很多男同胞都因为#瑞士卷怎么分#被考试我不仅没有考试，还有瑞士卷吃,114,28,4,118
272,-1,5.1E+15,2050260197,胖哥杨力,#瑞士卷怎么分席卷全网老公#真tm有病，艹！这东西像鱼子酱、松露、和牛那样这么贵吗？媳妇儿爱吃孩子爱吃，多买一盒不行吗？！缺钱的话找我，我给你买！真的想再次对这无聊的热搜说一句，艹！！,165,63,5,170
273,-1,5.1E+15,6883345759,我又了解山姆了,瑞士卷怎么分。一共8个瑞士卷，夫妻拢共生6个孩子就好分了。到时候还可以拍一条爆赞的短视频，全家人捧着瑞士卷从房间里手牵手有序出来：这是八〇后老公，这是〇〇后老婆，这是大女儿招娣，这是二女儿盼娣，这是三女儿来娣，这是四女儿迎娣，这是五女儿念娣，这是小儿子耀祖。,1304,21,27,1331
274,-1,5.1E+15,6715161617,大手拉小手1106,昨天那8个瑞士卷怎么分后续，本来想找点茬，结果昨天人家都不回我，忙完直接闪我一个电话：你真买了8个，那不够分嘛，我在面包店，还想吃点啥？我：…………然后人家今天看到新闻,18,9,0,18
275,-1,5.1E+15,5646295690,坚持吃饭减肥的毛毛,#瑞士卷怎么分#瑞士卷这个话题我试着拿来问我老公，他直接说：家里吃什么他没有发言权，能给他留点就不错啦！我觉得很离谱，想吃的零食买来肯定自己先吃然后再给孩子，男人不吃零食！,9,13,0,9
276,-1,5.1E+15,6192877183,篮球面对面,孙颖莎问王楚钦，8个瑞士卷怎么分？王楚钦首轮对阵户上隼辅#王楚钦##平野美宇#L篮球面对面的微博视频,0,0,0,0
277,-1,5.1E+15,6376325189,胃癌专家黄华教授,这种虚假段子除了占用社会公共资源，还刺激诱发甚至加剧社会撕裂，其危害不容小觑。如果不认真研究立法加大处罚力度。这种恶意摆拍的行为必定会层出不穷。过几天你会看到“8个泡芙怎么分”，“8个提拉米苏怎么分”。如果是以经济利益为目的恶意制造虚假故事情节，是不是可以以诈骗罪处罚？当然这需要法学及法律专家研究。#分享黄华医生的日常生活和各种废话#【#别掉进8个瑞士卷怎么分的话题陷阱#】#瑞士卷怎么分别成为第二个秦朗丢作业##瑞士卷消费降级#“8个瑞士卷怎么分？”近日，相关词条冲上了热搜。据报道，这个问题源自一女子在网络上发布的一则视频。视频记录了她与老公的一次争吵：家里买了一盒瑞士卷，总共8个，女儿吃了2个，儿子吃了2个，老公吃了2个。夜深孩子们都睡了以后，她拿出剩下的2个瑞士卷自己吃，还没进嘴里，就遭到了老公的一顿批评，理由是家长应多以身作则多吃正餐少吃零食，而且如果妈妈吃了，孩子就没得吃了。初看这个问题，还以为是一道数学题。仔细一看，原来是道“伦理题”。视频中女子感叹，原来自己已经卑微到连自主吃一个小蛋糕的权利都没有了。在网传的视频配文中，她提及和女儿说起想和丈夫离婚时，女儿小小的身体哭得发抖，于是她就只能妥协了。理性地说，有两种可能，一是这条视频记录的是真事。生活中，有的夫妻就是容易因为生活琐事而产生较大的争端，甚至因饭菜不合口味、因谁来做饭而吵到家庭“崩盘”的案例也有不少。当然，也有一种可能，视频内容只是一个段子。正如一些网友怀疑这多半是编的，就是为了挑起对立和矛盾来博取流量。无论事件性质如何，旁人都不妨把它当成一段网络“花絮”看待就好。正应了这句话，一旦把“花絮”当成严肃话题，不仅正襟危坐地“做题”，还陷入牛角尖，甚至影响到自己的价值判断和家庭稳定，那就属于别人挖坑自己跳了。确实，谁都有权利评判一件事，且谁也无法预料自己的一次点击会成为网络海啸的一份力量，但须知，“秦朗巴黎丢作业”的殷鉴不远，点到为止，远离“话题撕裂”，不扩大，不伤人，也是一种有意义的理性。,13,1,1,14
278,-1,5.1E+15,7079515851,受78924,#瑞士卷怎么分#大型纪录片《瑞士卷怎么分》持续为您播出L受78924的微博视频,10,0,0,10
279,-1,5.1E+15,1940798632,应旺,“8个瑞士卷引发的家庭大战？”近日，这个话题冲上热搜，让无数网友大呼惊奇，难道分瑞士卷也成了门学问？#瑞士卷消费降级#原来，事情的起因是一女子在网上发布的视频，视频里她和老公因为一盒瑞士卷吵得不可开交。家里总共8个瑞士卷，儿女各吃了2个，老公也吃了2个，剩下的2个女子想留着自己吃，结果老公却跳出来指责她，说家长应该以身作则，多吃正餐少吃零食，不然孩子没得吃。女子听后心寒不已，感叹自己连吃个小蛋糕的权利都没有。更让人心酸的是，当她和女儿说起想和老公离婚时，女儿竟吓得浑身发抖，只能无奈妥协。这则视频一出，网友们也是炸开了锅。有人觉得这就是生活中的琐事，夫妻间难免会因为小事争吵；也有人觉得这视频太假，纯粹就是为了博眼球、赚流量。但不管真相如何，我们都应该把它当成一段网络“花絮”，一笑而过。如果把这种“花絮”当成严肃话题，不仅会让自己陷入牛角尖，还可能影响到自己的价值判断和家庭稳定。毕竟，网络世界真真假假，谁也无法预料自己的一次点击会引发什么后果。就像之前的“秦朗巴黎丢作业”事件一样，一旦陷入话题撕裂，不仅伤人伤己，还可能引发更大的网络海啸。所以，让我们一起保持理性，远离“话题陷阱”，把网络世界当成生活的调味品，点到为止，不扩大，不伤人。欢迎大家在评论区留言，分享你的看法和故事。#瑞士卷怎么分#,65,46,30,95
280,-1,5.1E+15,7214726304,鲁迅买墨急,【评论丨#别掉进8个瑞士卷怎么分的话题陷阱#】#瑞士卷怎么分别成为第二个秦朗丢作业#“8个瑞士卷怎么分？”近日，相关词条冲上了热搜。据报道，这个问题源自一女子在网络上发布的一则视频。视频记录了她与老公的一次争吵：家里买了一盒瑞士卷，总共8个，女儿吃了2个，儿子吃了2个，老公吃了2个。夜深孩子们都睡了以后，她拿出剩下的2个瑞士卷自己吃，还没进嘴里，就遭到了老公的一顿批评，理由是家长应多以身作则多吃正餐少吃零食，而且如果妈妈吃了，孩子就没得吃了。初看这个问题，还以为是一道数学题。仔细一看，原来是道“伦理题”。视频中女子感叹，原来自己已经卑微到连自主吃一个小蛋糕的权利都没有了。在网传的视频配文中，她提及和女儿说起想和丈夫离婚时，女儿小小的身体哭得发抖，于是她就只能妥协了。理性地说，有两种可能，一是这条视频记录的是真事。生活中，有的夫妻就是容易因为生活琐事而产生较大的争端，甚至因饭菜不合口味、因谁来做饭而吵到家庭“崩盘”的案例也有不少。当然，也有一种可能，视频内容只是一个段子。正如一些网友怀疑这多半是编的，就是为了挑起对立和矛盾来博取流量。无论事件性质如何，旁人都不妨把它当成一段网络“花絮”看待就好。正应了这句话，一旦把“花絮”当成严肃话题，不仅正襟危坐地“做题”，还陷入牛角尖，甚至影响到自己的价值判断和家庭稳定，那就属于别人挖坑自己跳了。确实，谁都有权利评判一件事，且谁也无法预料自己的一次点击会成为网络海啸的一份力量，但须知，“秦朗巴黎丢作业”的殷鉴不远，点到为止，远离“话题撕裂”，不扩大，不伤人，也是一种有意义的理性。O网页链接O评论丨别掉进“八个瑞士卷怎么分”的话题陷阱,0,0,0,0
281,-1,5.1E+15,7214726304,鲁迅买墨急,#瑞士卷怎么分别成为第二个秦朗丢作业#最近，一则名为'8个瑞士卷怎么分'的视频在网上引起了广泛关注。视频中，一位女子讲述了她与丈夫因最后一盒瑞士卷的分配发生争执的经历。家里买了8个瑞士卷，女儿和儿子各自吃了2个，丈夫也吃了2个。深夜，孩子们都睡着了，女子准备吃剩下的2个瑞士卷时，遭到丈夫的批评，原因是家长应该多吃正餐少吃零食，而且如果妈妈吃了，孩子就没有了。视频中的女子感叹自己已经卑微到连吃个小蛋糕的权利都没有了。她在视频配文中提到，曾向女儿提起过想要离婚，但女儿哭了很久，最终她选择了妥协。这段视频迅速在网络上传播，引发了大量讨论。对于视频的真实性，网友们持有不同的看法。一方认为这是一个真实的生活片段，反映了一些现代家庭中常见的沟通问题和权力失衡现象。另一方则怀疑视频是故意制造的段子，目的是博取流量和关注度。除了真实性的问题，视频还引发了关于家庭伦理、个人权益和性别平等等一系列讨论。许多人认为，这种看似简单的家务事实际上揭示了更深层次的社会问题。有人批评视频中的男子对妻子的行为过于苛刻，认为这是一种不公平的待遇。还有一些网友指出，此类事件往往是人为制造的营销热点，目的是吸引观众的注意力和提升博主的知名度。他们认为，视频中的情节设计和台词安排显得过于戏剧化，不符合现实生活中的实际情况。此外，视频还引发了关于消费降级的讨论。有人认为，从之前的吃榴莲、吃草莓尖尖到现在吃瑞士卷，这些话题反映了现代人在面对经济压力时的心态变化。但也有人认为，这种过度关注小事的做法会让公众忽视更重要的社会问题。无论如何，这次事件再次提醒公众，在享受互联网带来的便利的同时，要警惕那些可能会加剧社会分裂和个体焦虑的虚假信息或夸张报道。理性看待这类事件，避免盲目参与不必要的舆论战，是非常必要的。,0,1,0,0
282,-1,5.1E+15,7214726304,鲁迅买墨急,【#瑞士卷怎么分席卷全网老公#】这两天，“瑞士卷怎么分”应该已经成为每一位老公的必考题了。#8个瑞士卷宝妈吃几个不自私#事情的起因得追溯到一条相当气人的视频，10月28日，一位全职宝妈在社交平台上发布了一条视频。视频的内容记录了她与老公的一次争吵，争吵的原因简单到你难以想象。宝妈当天买了一盒瑞士卷，总共8个瑞士卷，女儿吃了2个，儿子吃了2个，老公吃了2个。夜深孩子们都睡了以后，她自然认为剩下2个瑞士卷该自己吃，没想到蛋糕还没进嘴里，却遭到了老公的一顿批评。至于为什么不让吃，她老公给出的理由是：①他认为瑞士卷是零食，自己老婆应该吃饭的时候多吃饭，这样才算给孩子们当榜样，而不是晚上吃零食。②他认为，瑞士卷他老婆吃了，孩子就没得吃了，所以吃瑞士卷是自私的行为。一顿话下来把老婆都气无语了。当初是你让我当全职妈妈的，现在却吃个蛋糕都要管东管西。结果，老公根本没想着去听宝妈的话，反手就是否认三连，把一句“你又想多了”扣在宝妈头上。在网友们愤愤不平的同时，“我可以吃几个瑞士卷”也成为了全网老公们的必考题。（脊梁in上海SH）,2,2,0,2
283,-1,5.1E+15,3303480313,秦东记,#瑞士卷怎么分#八个瑞士卷怎么分？这个问题早在20年前刘星就教过大家了：老妈一个我一个，老爸一个我一个，小雪一个我一个，小雨一个我一个。哈哈哈~(¯▽¯~)~,2,2,0,2
284,-1,5.1E+15,7214726304,鲁迅买墨急,#别掉进8个瑞士卷怎么分的话题陷阱#最近，‘8个瑞士卷怎么分’的视频在网络平台上引起了广泛讨论。视频展示了一个妻子和丈夫因为家中剩余的两个瑞士卷产生了争执。妻子抱怨丈夫对她吃零食的行为进行了严厉批评，认为家长应该以身作则少吃什么的。这段视频迅速登上了热搜榜，引发了大量网民的关注和讨论。面对这场突如其来的热度，网友们的意见分歧很大。一部分人认为视频反映了一些现实生活中常见的小摩擦，夫妻双方因为日常琐事发生争执并不罕见。但也有很多人怀疑视频内容的真实性，认为这只是一种为了吸引流量而特意编排的剧情。随着讨论的不断升温，视频发布者最终删除了原帖，并表示自己无意传递负面情绪，同时也否认了有关炒作的说法。不过，即便如此，仍有不少网友对此持怀疑态度，认为视频背后有着更深的商业动机。许多评论者指出，‘8个瑞士卷怎么分’的问题实际上毫无意义，却很容易引发不必要的争论和家庭矛盾。有人认为这是一种精心设计的话题陷阱，目的是挑拨夫妻关系，引发争议，甚至可能触及性别歧视等问题。因此，大家应当警惕这种无聊的话题，避免落入别人的圈套。还有一些声音提醒人们，不应过分关注这类琐碎的事情，而是应该更多地关注真正有价值的社会议题。毕竟，每个人都有权利自由支配自己的食物，无需受到外界过多干涉。与其浪费时间在这类无谓的争论上，不如多关心一下身边真正重要的事情。,0,0,0,0
285,-1,5.1E+15,7214726304,鲁迅买墨急,#瑞士卷怎么分的起因#2024年10月28日，一位全职宝妈在社交平台上发布了一段视频，记录了她与丈夫之间的一次争吵。争吵的原因是因为如何分配剩余的两个瑞士卷。宝妈当天买了一盒共8个瑞士卷，女儿和儿子各吃了2个，老公也吃了2个。夜深孩子们都睡了以后，宝妈本以为剩下的2个瑞士卷归自己，却被老公批评了一番。老公的理由主要有两点：一是他认为瑞士卷是零食，妻子应该在饭时多吃正餐；二是他认为如果妻子吃了瑞士卷，孩子们就没有份了，因此这种行为是自私的。这段视频迅速在网络上引起了关注。视频发布后，‘瑞士卷怎么分’迅速成为了一个热门话题。许多网友表达了对这位宝妈的支持，认为她的丈夫太过苛刻和自私。有网友认为这是一个剧本摆拍，但也有很多人表示这种情况在生活中确实会发生。这场争论不仅反映了夫妻间的沟通问题，还引发了对家庭内部资源分配和性别角色的广泛讨论。一些情侣也开始用这个问题来测试彼此的感情，试图通过这种方式证明自己是被爱的。'瑞士卷怎么分'的问题逐渐演变成了一场社会现象，许多人借此机会讨论了夫妻关系中的权力平衡和沟通技巧。一些评论者指出，这样的小事往往反映出更大的家庭管理问题，包括经济支持、家务分工和子女教育等方面。还有人提到，女性在家庭中的地位和权利也应该受到更多重视，尤其是在享受个人乐趣方面。尽管如此，也有声音提醒大家不要过度解读，以免造成不必要的对立和矛盾。,0,1,0,0
286,-1,5.1E+15,5673874565,林步里,#瑞士卷怎么分#话说，我并不是把食物留给孩子吃的那种娘，因为现在不是一个做妈妈的非得委屈自己，留给孩子物质缺乏的时代。我属于好吃的自己的也必须吃够，所以，我会买多一点，每个人都够吃，不会分起来不够。这种可能摆拍，不排除现实生活中有这种情况。那我只能说，成年人，可以用自己的经济，买多一点，就不用看别人的脸色。,116,29,3,119
287,-1,5.1E+15,7214726304,鲁迅买墨急,#瑞士卷怎么分的起因#【瑞士卷怎么分席卷全网老公】#瑞士卷怎么分成老公必考题#据新闻晨报这两天，“瑞士卷怎么分”应该已经成为每一位老公的必考题了。事情的起因得追溯到一条相当气人的视频，10月28日，一位全职宝妈在社交平台上发布了一条视频。视频的内容记录了她与老公的一次争吵，争吵的原因简单到你难以想象。宝妈当天买了一盒瑞士卷，总共8个瑞士卷，女儿吃了2个，儿子吃了2个，老公吃了2个。夜深孩子们都睡了以后，她自然认为剩下2个瑞士卷该自己吃，没想到蛋糕还没进嘴里，却遭到了老公的一顿批评。至于为什么不让吃，她老公给出的理由是：①他认为瑞士卷是零食，自己老婆应该吃饭的时候多吃饭，这样才算给孩子们当榜样，而不是晚上吃零食。②他认为，瑞士卷他老婆吃了，孩子就没得吃了，所以吃瑞士卷是自私的行为。一顿话下来把老婆都气无语了。当初是你让我当全职妈妈的，现在却吃个蛋糕都要管东管西。结果，老公根本没想着去听宝妈的话，反手就是否认三连，把一句“你又想多了”扣在宝妈头上。在网友们愤愤不平的同时，“我可以吃几个瑞士卷”也成为了全网老公们的必考题。瑞士卷怎么分（脊梁in上海SH）,0,1,0,0
288,-1,5.1E+15,1159321272,邱锴俊,#瑞士卷怎么分#？我还以为是怎么切。我们家，娃一日三餐幼儿园都管。我减肥，老婆减肥，瑞士卷经常一放放太久。那买了干啥？儿子要的。,0,0,0,0
289,-1,5.1E+15,1167257004,罗妮zyzyyuan,张爱玲实在才华横溢，《小团圆》里“家里穷，可以连吃只水果都成了道德问题”，对应了现在的“瑞士卷应该怎么分”社会大讨论。,1213,14,58,1271
290,-1,5.1E+15,7380722614,趣你的书小生,爱怎么分怎么分！一下子想到以前的那个朋友了，那时还没有短视频小红书，但是有那个什么QQ美文，专有一路人写那些艹蛋的情感文章，天天看那个的人矫情得要死，印章最深的还是系鞋带#瑞士卷怎么分#,4,2,0,4
291,-1,5.1E+15,1766266385,严娜妍,11月3日（发布时间），山东烟台。一觉醒来，全网老公都在回答吃几个瑞士卷？这位是唯一起来动身去找的，立马要吃到！#瑞士卷怎么分#L严娜妍的微博视频,2,0,0,2
292,-1,5.1E+15,2297255040,李桂江,#假如用AI来分瑞士卷#首先，我们来看看一下问题：家中一盒8个瑞士卷，父亲和两个孩子各吃2个后，母亲准备吃剩下2个时，丈夫不满，以瑞士卷“零食”身份质问妻子。假如用AI来分瑞士卷，会如何完美化解问题？既然是在AI会怎么分的话，那我们就用AI来试一下：#瑞士卷怎么分#？在这个关于分配瑞士卷的家庭情境中，AI可以作为一个智能、公正且考虑周全的调解者来介入，以公平、合理且可能带有一定情感智能的方式分配食物，并化解家庭成员间可能产生的矛盾。以下是一个基于AI分配方案的设想：数据收集与分析：AI首先会询问或自动获取家庭成员对瑞士卷的偏好程度（虽然在这个案例中可能不太适用，因为大家都吃了，但可以作为未来分配时的参考）。了解家庭成员的饮食习惯、营养需求（比如是否有人需要控制糖分摄入）以及当前的饥饿状态。规则设定：设定一个基本原则，比如“公平分配”或“按需分配”，并结合家庭成员的共识来制定具体规则。在这个案例中，可以设定规则为“已吃的不影响剩余分配，剩余部分应公平考虑所有成员的需求”。智能分配：AI分析当前情况：8个瑞士卷，父亲和两个孩子各吃了2个，剩下2个。考虑到已吃的情况不再追溯，AI会关注剩余的2个瑞士卷如何分配。可以提出几种方案供家庭成员选择，比如：方案一：母亲吃一个，剩下的一个留给最想吃或最需要的人（通过家庭成员的简短讨论决定）。方案二：如果大家都对剩余的两个瑞士卷没有特别强烈的欲望，可以提议将这两个保存起来作为明天的早餐或下午茶。方案三：如果家庭成员愿意，可以提议进行某种小游戏或抽签，胜者获得剩余的瑞士卷。沟通与解释：AI会清晰地解释每种方案的逻辑和合理性，帮助家庭成员理解并接受最终的分配结果。AI还可以鼓励家庭成员之间表达自己的想法和感受，促进开放和诚实的沟通。情感智能：AI可以识别并响应家庭成员的情绪变化，特别是丈夫的不满情绪，通过温和的语气和逻辑清晰的解释来平息他的不满。AI可以强调家庭和谐的重要性，并提醒所有成员在分配资源时考虑彼此的感受和需求。学习与反馈：AI会记录这次分配的过程和结果，以及家庭成员的反馈，以便在未来遇到类似情况时能够更准确地判断和调整分配策略。通过这样的AI分配方案，不仅可以公平合理地分配剩余的瑞士卷，还能促进家庭成员之间的理解和沟通，减少矛盾的发生。看到了没有，这个AI还是很懂的，照顾到了所有人的感受，可以说现在的AI也太会啦，不只是冷冰冰的数据分析啦。#瑞士卷消费降级#,27,4,0,27
293,-1,5.1E+15,3953801432,超桃花美少男,【#瑞士卷与婆媳同时掉河里一样没必要#】近段时间，“八个瑞士卷怎么分”成全网老公的必考“送命题”。全职妈妈累了一天了，好不容易哄睡了孩子们，终于拥有了属于自己的时间，吃块瑞士卷放松放松，结果被老公一顿数落。网友们很生气，但却不妨碍“八个瑞士卷”的梗持续产出。其实网友们的玩梗，无非是表达自己能“瑞士卷自由”的幸福。但还有一个角度是，不管是女性还是男性，身份是爸爸或是妈妈，在“家庭”这个语境下，吃几个瑞士卷？甚至吃什么，是自己可以做决定的事，而不应该被任何情感“绑架”。八个瑞士卷怎么分？就像那个经典“送命题”，婆媳同时掉进河里，你先救谁？这个问题除了挑起婆媳之间的情感纷争，毫无意义。家庭中的爱不应该是一场情感博弈，而我们想要得到的答案，也不是“我能吃几个瑞士卷”，而是希望能有自己做选择的权利。#瑞士卷消费降级##瑞士卷怎么分别成为第二个秦朗丢作业#L潇湘晨报的微博视频,225,93,0,225
294,-1,5.1E+15,5632150618,财主仁,#瑞士卷消费降级#28.8的瑞士卷，最后因为怎么分，又是批评，又是离婚，是不是家庭，早就出现什么问题？都说贫贱夫妻百事哀，就像菜师说的，人在特别痛苦的环境里，会为了求生，而失去理智。因为妻子吃掉两个瑞士卷，就批评妻子的丈夫，因为丈夫的一句批评，就和女儿说要和爸爸离婚的母亲，难道他们真的不知道，这么做不对吗？不，他们知道，只不过，在某个瞬间，他们的内心崩溃了（菜师这句话说的太秒了）。人生不易，且行且珍惜。下一个不一定更好，更多的情况是，还不如上一个。,13,5,0,13
295,-1,5.1E+15,5417515998,狮子头萌萌,参考#瑞士卷怎么分#，图里这是男作家坐在书房里编的吧，能不能不要“为赋新词强说愁”？,10816,4,15,10831
296,-1,5.1E+15,6542962814,高尚GSS,#假如AI来分瑞士卷#小布答案如下，那如果是你们，会怎么分,64,22,3,67
297,-1,5.1E+15,1837242684,金华小陈说事,#瑞士卷怎么分#怎么还在研究这个话题都说了十有八九像剧本！我看现实中老公和小孩能不能吃饭都是个问题。#瑞士卷怎么分别成为第二个秦朗丢作业#,5,0,0,5
298,-1,5.1E+15,5662178452,财金plus,价格战。今年是所在行业打价格战元年。你出五折，我出四折，什么他丫出3折，我去。这就是今年截止到10月份市场的真实情况。打价格战中标后赚钱吗？不赚钱，为什么要低价呢，为了生存，人要养，设备要出，低价拿个单，人员货物还转一转，回拢些资金，人员也有事情做，要不然大家守着仓库的设备系统，大眼瞪小眼吗。为什么打价格战？市场规模萎缩了，数据统计我所在行业今年市场萎缩了30-35%，明年预计只会更萎缩。怎么办？找到增量市场，去抢别人的蛋糕，目前行业内已经有开拓固有市场以外市场的具体导向和目标，大家要做好准备，原来食物链上层的那些公司单位开始向下找食吃，开始降维打击。会怎么样？降维打击之下，在食物链下层的可能会资金链断掉而毕业。毕业之后怎么办？托底的吉祥三宝，网约车，快递，外卖小哥，思想一变天地宽。#瑞士卷怎么分#一人买一盒就好了，分什么分。,50,30,1,51
299,-1,5.1E+15,5649170494,兰州微播,【#瑞士卷事件博主删除视频#，#瑞士卷事件博主否认摆拍制造对立#】近日，一博主发布的“吃2个瑞士卷换来老公的一顿教育”吐槽视频，让“瑞士卷怎么分”持续引发热议。有网友顺势“拷问”起自己的甚至全天下的“老公”；也有网友怀疑是“剧本”，纯粹博取流量。目前，当事博主已删除视频，称不想继续传播负能量。但否认摆拍、搞男女对立。#别掉进8个瑞士卷怎么分的话题陷阱#,1,2,0,1
300,-1,5.1E+15,3051949107,兰州微导航,【#瑞士卷事件博主删除视频#，#瑞士卷事件博主否认摆拍制造对立#】近日，一博主发布的“吃2个瑞士卷换来老公的一顿教育”吐槽视频，让“瑞士卷怎么分”持续引发热议。有网友顺势“拷问”起自己的甚至全天下的“老公”；也有网友怀疑是“剧本”，纯粹博取流量。目前，当事博主已删除视频，称不想继续传播负能量。但否认摆拍、搞男女对立。#别掉进8个瑞士卷怎么分的话题陷阱#,5,2,0,5
301,-1,5.1E+15,3939212872,可爱的春雷王,#假如AI来分瑞士卷#最近一个小小的瑞士卷引发全网热议，我很自然的觉得AI肯定是均分啊，没想到它给了我五种方法，各位看官你们会怎么分？,1,1,0,1
302,-1,5.1E+15,3256966805,透明人間的蒸气,咯噔//@狮子头萌萌:参考#瑞士卷怎么分#，图里这是男作家坐在书房里编的吧，能不能不要“为赋新词强说愁”？,10816,13,14,10830
303,-1,5.1E+15,6870070356,伟龙零食俱乐部,❌你们不要再吵了啦！瑞士卷分不到的都看这里�#伟龙小饼干#薄脆好吃又有料每一盒里都是独立包装，轻松分享零食的快乐关�+转评，抽2个人吃【方便分享的小饼干】#瑞士卷怎么分##瑞士卷消费降级#O抽奖详情,120,187,271,391
304,-1,5.1E+15,6787667246,一岱涛,#瑞士卷怎么分##瑞士卷消费降级#我小时候很爱吃瑞士卷，真的很好吃，瑞士卷的价格算是很实惠的。最近，瑞士卷成为了衡量消费降级的新指标，以前大家还在计较买金买银、买榴莲、买化妆品，但现在就连瑞士卷也要考虑值不值得买了。买瑞士卷不代表消费降级，有时候买瑞士卷是因为喜欢吃。,41,20,0,41
305,-1,5.1E+15,5404290229,普通用户雨墨寒,给the9吃8个瑞士卷，怎么分？,190,37,11,201
306,-1,5.1E+15,3239495534,笑得我鼻孔都没啦,瑞士卷怎么分，看过最搞笑的一个哈哈哈哈哈哈哈,313,20,2,315
307,-1,5.1E+15,6787667246,一岱涛,#瑞士卷怎么分##瑞士卷怎么分别成为第二个秦朗丢作业#每当看到这种事，都会觉得是不是在博眼球，希望瑞士卷不要成为第二个“秦朗丢作业”。瑞士卷事件虽然看似是一件小事，但它凸显了许多深层次的问题，无论是家庭内部的沟通障碍，还是网络热点的炒作现象，都需要我们理性对待，保持冷静，避免盲目跟风。,41,20,0,41
308,-1,5.1E+15,5426716682,西马光夹缸,不理解为什么要去问老公八个瑞士卷怎么分这种问题，第一凭什么老公才有分配权，第二我不爱吃瑞士卷,145,32,2,147
309,-1,5.1E+15,6787667246,一岱涛,#瑞士卷怎么分##瑞士卷#一位宝妈买了8个瑞士卷，两个孩子一共吃了4个，她老公吃了2个，剩下2个她打算自己吃的时候遭到老公的责备。妈妈带孩子也很辛苦，既然爸爸吃了两个瑞士卷，那妈妈也吃两个瑞士卷是合理的，不够吃再买，身为丈夫应该多心疼妻子。,41,20,0,41
310,-1,5.1E+15,5608873424,大大大餅干丶,瑞士卷怎么分？你还在纠结瑞士卷怎么分？你还沉溺于舆论漩涡，人家聪明人已经在准备直播带货了～#瑞士卷消费降级##网友争论瑞士卷怎么分#,25,9,6,31
311,-1,5.1E+15,6622446302,子夜笙歌落ing,近日，网上热传了一条全职妈妈吃瑞士卷被老公数落的视频，一觉醒来，瑞士卷测试竟成已婚男士“统考”题目，引发无数网友调侃。有提前看过视频坚决不肯上当的，也有不明就里直接掉坑里的，还有不少高糖式回答......总之，爱并不是意味着牺牲和奉献，有的时候也是共享和平等。一块小小的瑞士卷，折射出了部分家庭全职妈妈的境遇。但是，如果没有一个人在家里支撑，另外一个人怎么可能没有后顾之忧地安安心心上班挣钱呢？#瑞士卷怎么分#L子夜笙歌落ing的微博视频,3,2,2,5
312,-1,5.1E+15,6622446302,子夜笙歌落ing,#瑞士卷怎么分#一共8个瑞士卷，夫妻拢共生6个孩子就好分了。到时候还可以拍一条爆赞的短视频，全家人捧着瑞士卷从房间里手牵手有序出来：这是八〇后老公，这是〇〇后老婆，这是大女儿招娣，这是二女儿盼娣，这是三女儿来娣，这是四女儿迎娣，这是五女儿念娣，这是小儿子耀祖。,5,4,4,9
313,-1,5.1E+15,7194896200,骑叔荡天涯,#瑞士卷怎么分#合理？快来直播间参与投票表态~骑叔荡天涯的微博直播,0,0,0,0
314,-1,5.1E+15,5649170494,兰州微播,【#瑞士卷怎么分当事博主回应#】#瑞士卷怎么分当事博主否认摆拍#近日，“瑞士卷怎么分”议题火遍全网，引发大量讨论。事情的起因是一位全职宝妈发布了这样一条视频：宝妈买了8个瑞士卷，女儿吃了2个，儿子吃了2个，老公吃了2个。夜深孩子们都睡了以后，她认为剩下2个瑞士卷该自己吃，没想到遭到了老公的批评。11月4日，事件当事博主回应称，视频是真实的，删除是因为负能量太多了，看着都压抑，不想继续传播下去。#8个瑞士卷宝妈吃几个不自私#L长江云新闻的微博视频,0,4,0,0
315,-1,5.1E+15,3051949107,兰州微导航,【#瑞士卷怎么分当事博主回应#】#瑞士卷怎么分当事博主否认摆拍#近日，“瑞士卷怎么分”议题火遍全网，引发大量讨论。事情的起因是一位全职宝妈发布了这样一条视频：宝妈买了8个瑞士卷，女儿吃了2个，儿子吃了2个，老公吃了2个。夜深孩子们都睡了以后，她认为剩下2个瑞士卷该自己吃，没想到遭到了老公的批评。11月4日，事件当事博主回应称，视频是真实的，删除是因为负能量太多了，看着都压抑，不想继续传播下去。#8个瑞士卷宝妈吃几个不自私#L长江云新闻的微博视频,3,8,0,3
316,-1,5.1E+15,5124879782,一个棱镜,#瑞士卷怎么分##花儿与少年#八个瑞士卷，给花少6怎么分？,2,1,0,2
317,-1,5.1E+15,7549758301,谢顶妹妹,#假如AI来分瑞士卷#问了蓝心小v最近争议很大的瑞士卷事件连AI都知道这瑞士卷该怎么分，但是有些人的脑子却不会,263,38,14,277
318,-1,5.1E+15,3766814100,梁小欣同学,我刚刚问了我的小艺助手八个瑞士卷，四个人怎么分的问题#假如AI来分瑞士卷#，它给出了几组方案，你们看看对不对：最直接的当然就是平均分配了，但这是很直男的做法。第二种就是根据家里人员的情况分配，例如有小孩的情况可以多给点，那么大人就少吃了，我想这应该也是大部分中国家的做法吧？还有一种是每天吃一个，每个人轮流吃，你们觉得如何？,13,13,6,19
319,-1,5.1E+15,2001530981,空警世界,#瑞士卷怎么分#在我家倒是很容易，领导不吃甜，舔一舔，哈哈。我觉得吧，老公没啥理由不让老婆吃两块，人人有份嘛，全家都分一份。#瑞士卷消费降级#,0,0,0,0
320,-1,5.1E+15,1584389614,偷故事的宇宙人,#假如AI来分瑞士卷#真的搞不懂为什么他们会因为这个吵架，按照正常逻辑惯例，将8个瑞士卷进行平分，每人2个，剩余2个一个给孩子一个夫妻平分，又或者孔融让梨。再来看看AI怎么回答这个问题，AI给出的答案有5个：平均分配、按需分屏、优先满足孩子、轮流分屏、随机分配，这几个方式除了公平，还增加了少许趣味性,3,2,1,4
321,-1,5.1E+15,6055859683,我是电竞小生,#瑞士卷怎么分#实话实说，刷到好多视频了，但不知道这个话题怎么火起来的！看的一头雾水！有网友说一下吗？,1,0,0,1
322,-1,5.1E+15,5985166710,嗨兰州,【#瑞士卷事件博主删除视频#，#瑞士卷事件博主否认摆拍制造对立#】近日，一博主发布的“吃2个瑞士卷换来老公的一顿教育”吐槽视频，让“瑞士卷怎么分”持续引发热议。有网友顺势“拷问”起自己的甚至全天下的“老公”；也有网友怀疑是“剧本”，纯粹博取流量。目前，当事博主已删除视频，称不想继续传播负能量。但否认摆拍、搞男女对立。#别掉进8个瑞士卷怎么分的话题陷阱#,5,6,0,5
323,-1,5.1E+15,6207368316,浅浅夏目泷,#8个瑞士卷宝妈吃几个不自私##瑞士卷怎么分##瑞士卷消费降级#就几个瑞士卷而已，那么难分吗，实在不行多买几个，瑞士卷能有多贵，非要在这抠，看不下去了,12,15,0,12
324,-1,5.1E+15,3855163795,宅女雪球rua,#瑞士卷怎么分#一共8个瑞士卷，夫妻拢共生6个孩子就好分了。到时候还可以拍一条爆赞的短视频，全家人捧着瑞士卷从房间里手牵手有序出来：这是八〇后老公，这是〇〇后老婆，这是大女儿招娣，这是二女儿盼娣，这是三女儿来娣，这是四女儿迎娣，这是五女儿念娣，这是小儿子耀祖。,4,3,3,7
325,-1,5.1E+15,5649170494,兰州微播,【#瑞士卷怎么分席卷全网老公#】这两天，“瑞士卷怎么分”应该已经成为每一位老公的必考题了。#8个瑞士卷宝妈吃几个不自私#事情的起因得追溯到一条相当气人的视频，10月28日，一位全职宝妈在社交平台上发布了一条视频。视频的内容记录了她与老公的一次争吵，争吵的原因简单到你难以想象。宝妈当天买了一盒瑞士卷，总共8个瑞士卷，女儿吃了2个，儿子吃了2个，老公吃了2个。夜深孩子们都睡了以后，她自然认为剩下2个瑞士卷该自己吃，没想到蛋糕还没进嘴里，却遭到了老公的一顿批评。至于为什么不让吃，她老公给出的理由是：①他认为瑞士卷是零食，自己老婆应该吃饭的时候多吃饭，这样才算给孩子们当榜样，而不是晚上吃零食。②他认为，瑞士卷他老婆吃了，孩子就没得吃了，所以吃瑞士卷是自私的行为。一顿话下来把老婆都气无语了。当初是你让我当全职妈妈的，现在却吃个蛋糕都要管东管西。结果，老公根本没想着去听宝妈的话，反手就是否认三连，把一句“你又想多了”扣在宝妈头上。在网友们愤愤不平的同时，“我可以吃几个瑞士卷”也成为了全网老公们的必考题。（脊梁in上海SH）,1,2,0,1
326,-1,5.1E+15,7390754169,落日漫游时,8个蛋糕、瑞士卷，一个家庭三口怎么分，对于一个三口之家分8个蛋糕和瑞士卷，可以有以下几种分法：1. 平均分配法：-如果蛋糕和瑞士卷的口味差异不大，且每个人对这些食物的喜爱程度相近，可以将8个分成3份尽量平均的量。8除以3商2余2，那么可以爸爸妈妈各分3个，孩子分2个。因为孩子的食量相对较小，成年人食量稍大一些，这样分配相对公平。2. 按需求分配法：-如果有人特别喜欢吃蛋糕和瑞士卷，而有人相对没那么喜欢，可以根据个人需求来分。比如孩子特别喜欢吃，那么可以给孩子分4个，爸爸妈妈各分2个；或者如果妈妈比较喜欢吃甜品，也可以妈妈分4个，爸爸和孩子各分2个瑞士卷。3. 留余分配法：-考虑到一次吃太多蛋糕和瑞士卷可能会影响健康或导致腻味，可以先拿出一部分来分，剩下的留着以后吃。比如先拿出4个，爸爸、妈妈、孩子各分1个，然后剩下的4个放入冰箱，以后想吃的时候再拿出来分。4. 分享式分配法：-将8个蛋糕和瑞士卷都拿出来，大家一起吃，每个人根据自己的食量和喜好自由选择，直到吃完或者觉得差不多了为止。这样可以营造一个愉快的分享氛围，也不会因为固定的分配方式而让某个人觉得不够吃或者吃不完。#瑞士卷怎么分#/#瑞士卷消费降级#,0,2,100,100
327,-1,5.1E+15,3855163795,宅女雪球rua,近日，网上热传了一条全职妈妈吃瑞士卷被老公数落的视频，一觉醒来，瑞士卷测试竟成已婚男士“统考”题目，引发无数网友调侃。有提前看过视频坚决不肯上当的，也有不明就里直接掉坑里的，还有不少高糖式回答......总之，爱并不是意味着牺牲和奉献，有的时候也是共享和平等。一块小小的瑞士卷，折射出了部分家庭全职妈妈的境遇。但是，如果没有一个人在家里支撑，另外一个人怎么可能没有后顾之忧地安安心心上班挣钱呢？#瑞士卷怎么分#L宅女雪球rua的微博视频,4,2,2,6
328,-1,5.1E+15,3051949107,兰州微导航,【#瑞士卷怎么分席卷全网老公#】这两天，“瑞士卷怎么分”应该已经成为每一位老公的必考题了。#8个瑞士卷宝妈吃几个不自私#事情的起因得追溯到一条相当气人的视频，10月28日，一位全职宝妈在社交平台上发布了一条视频。视频的内容记录了她与老公的一次争吵，争吵的原因简单到你难以想象。宝妈当天买了一盒瑞士卷，总共8个瑞士卷，女儿吃了2个，儿子吃了2个，老公吃了2个。夜深孩子们都睡了以后，她自然认为剩下2个瑞士卷该自己吃，没想到蛋糕还没进嘴里，却遭到了老公的一顿批评。至于为什么不让吃，她老公给出的理由是：①他认为瑞士卷是零食，自己老婆应该吃饭的时候多吃饭，这样才算给孩子们当榜样，而不是晚上吃零食。②他认为，瑞士卷他老婆吃了，孩子就没得吃了，所以吃瑞士卷是自私的行为。一顿话下来把老婆都气无语了。当初是你让我当全职妈妈的，现在却吃个蛋糕都要管东管西。结果，老公根本没想着去听宝妈的话，反手就是否认三连，把一句“你又想多了”扣在宝妈头上。在网友们愤愤不平的同时，“我可以吃几个瑞士卷”也成为了全网老公们的必考题。（脊梁in上海SH）,0,2,0,0
329,-1,5.1E+15,1008428475,TODO普拉斯,#假如AI来分瑞士卷#一家四口，八个瑞士卷怎么分？问了一下我的AI助手们，感觉小艺，小爱，小布，小V，YOYO的回答都很合理，难道不就应该一人两个吗？,254,35,16,270
330,-1,5.1E+15,1098532113,土楼先生,妈妈充值3万玩游戏竟甩锅女儿这个话题讨论风向居然跟“8个瑞士卷怎么分”的讨论风向一致？,0,0,0,0
331,-1,5.1E+15,7721945396,茄汁好多鱼,关于瑞士卷这个事情，鉴于我损人不利己的发疯心态，大概率是我不仅要吃我还不让别人吃，我要吃一个再捏烂一个扔你脸上，还得把你吃下去的都打出来！#瑞士卷怎么分#,17,6,0,17
332,-1,5.1E+15,2678646793,财-肉肉,#瑞士卷怎么分#最近因为瑞士卷而引起了一众热浪，大家都纷纷问自己老公怎么分，给出的答案也是千奇百怪。我也看了视频，觉得这个男人也是无语到了极点。两块蛋糕怎莫了？只有你能是吗？想给孩子树立榜样，也不在乎这一口吃的！大家都是一家人，当然有好吃的先紧着孩子吃，剩下的我们大人再分着吃，至于吃多吃少是夫妻之间的事情。#瑞士卷消费降级#一直发酵到现在，也不知道大家怎么就想到了消费降级？衡量一个男人爱不爱你，这个就能验证出来？真是一个大笑话。蛋糕，现在大家都能吃的着，不像以前吃一块要等好久，有人喜欢买，有人不喜欢吃，有人暂时不买，怎么就能说消费降级！,55,24,0,55
333,-1,5.1E+15,1366047955,张好大_车评版,博主们丧失表达欲可再正常不过了。你们看看中文互联网的这些几把选题，美国大选你中国人支持谁、瑞士卷怎么分这种无聊透顶的讨论也能上榜。我的妈鸭。。那不过就是个瑞士卷而已！你爱几把吃几个就吃几个！不怕胖你就使劲吃！,42,18,1,43
334,-1,5.1E+15,5985166710,嗨兰州,【#瑞士卷怎么分当事博主回应#】#瑞士卷怎么分当事博主否认摆拍#近日，“瑞士卷怎么分”议题火遍全网，引发大量讨论。事情的起因是一位全职宝妈发布了这样一条视频：宝妈买了8个瑞士卷，女儿吃了2个，儿子吃了2个，老公吃了2个。夜深孩子们都睡了以后，她认为剩下2个瑞士卷该自己吃，没想到遭到了老公的批评。11月4日，事件当事博主回应称，视频是真实的，删除是因为负能量太多了，看着都压抑，不想继续传播下去。#8个瑞士卷宝妈吃几个不自私#L长江云新闻的微博视频,5,12,0,5
335,-1,5.1E+15,7398120660,大馨命鲤,真的跟真正优质男有钱男人富二代谈恋爱的女生不会问这种问题因为真的很掉身价这种问题都存在于那种生活实在没什么盼头，也没什么发展，只能靠薅一点情绪价值男生给多给你个瑞士卷，你生活就能衣食无忧了？你孩子就能上好学校以后有好工作了？你就能没有生活压力每天就买买买吃吃喝喝了？这只是剪男特别喜欢的话题，可以无限提供情绪价值但是大部分男生都是什么？瑞士卷就能搞定老婆？买！买两箱！不够再买！#别掉进8个瑞士卷怎么分的话题陷阱##瑞士卷怎么分#,72,11,8,80
336,-1,5.1E+15,7085556473,心智复利,#瑞士卷#“8个瑞士卷怎么分？”近日，这个看似简单的问题意外地成为了社交媒体上的热门话题。这个话题的起源是一个女子在网络上分享的视频，视频中记录了她与丈夫因为一盒瑞士卷而发生的争执。女子的女儿和儿子各吃了两个，丈夫也吃了两个，当她准备享用剩下的两个时，却遭到了丈夫的批评，认为作为家长应该以身作则，少吃零食，多鼓励孩子吃正餐。乍一看，这个问题似乎是一个简单的数学问题，但细究之下，它实际上是一个复杂的伦理问题。视频中的女子感叹自己连吃一个小蛋糕的权利都没有，这不禁让人深思。在视频的配文中，她提到了与女儿讨论离婚的可能性，女儿的恐惧和哭泣让她不得不妥协。无论事件的真实性如何，我们都应该将其视为网络生活中的一个小插曲。正如人们常说的，一旦将这些小插曲当作严肃话题来对待，不仅会陷入无谓的争论，还可能影响到自己的价值判断和家庭稳定，那就真的是自己跳进了别人挖的坑。在网络时代，我们更应该保持清醒的头脑，不被情绪化的舆论所左右，用理性的态度去看待每一个热点事件，避免成为话题陷阱的牺牲品。,2,2,0,2
337,-1,5.1E+15,7305188171,洋妈咪在哪里,#瑞士卷怎么分##瑞士卷怎么分别成为第二个秦朗丢作业#，如此低质量的摆拍为何会引起如此高流量的关注，“操盘手”在实现了热度、流量、带货业绩“三赢”外，却给社会留下撕裂和对抗，是时候对此类行为说不了，该引起相关部门重视了，再不挥出重拳、严处黑手，长此下去网络不能清朗，社会更不能安定。,0,1,0,0
338,-1,5.1E+15,5985166710,嗨兰州,【#瑞士卷怎么分席卷全网老公#】这两天，“瑞士卷怎么分”应该已经成为每一位老公的必考题了。#8个瑞士卷宝妈吃几个不自私#事情的起因得追溯到一条相当气人的视频，10月28日，一位全职宝妈在社交平台上发布了一条视频。视频的内容记录了她与老公的一次争吵，争吵的原因简单到你难以想象。宝妈当天买了一盒瑞士卷，总共8个瑞士卷，女儿吃了2个，儿子吃了2个，老公吃了2个。夜深孩子们都睡了以后，她自然认为剩下2个瑞士卷该自己吃，没想到蛋糕还没进嘴里，却遭到了老公的一顿批评。至于为什么不让吃，她老公给出的理由是：①他认为瑞士卷是零食，自己老婆应该吃饭的时候多吃饭，这样才算给孩子们当榜样，而不是晚上吃零食。②他认为，瑞士卷他老婆吃了，孩子就没得吃了，所以吃瑞士卷是自私的行为。一顿话下来把老婆都气无语了。当初是你让我当全职妈妈的，现在却吃个蛋糕都要管东管西。结果，老公根本没想着去听宝妈的话，反手就是否认三连，把一句“你又想多了”扣在宝妈头上。在网友们愤愤不平的同时，“我可以吃几个瑞士卷”也成为了全网老公们的必考题。（脊梁in上海SH）,5,6,0,5
339,-1,5.1E+15,5649170494,兰州微播,【已出现“人传人”！#吃几个瑞士卷成老公们的必答题#】#瑞士卷怎么分#近日，“我可以吃几个瑞士卷？”成为女生们问她们老公最多的一个问题。事情的起因是，一个宝妈买了8个瑞士卷，女儿2个，儿子2个，老公2个，最后剩2个宝妈想吃，结果老公一顿教育，要宝妈懂事点，把瑞士卷留给孩子吃！宝妈感叹她不配吃瑞士卷，太卑微了！这一事件引发女网友们的讨论，于是，她们纷纷拷问自己的老公：咱们家瑞士卷怎么分？你怎么看待这件事呢？一起讨论~@南方日报（图片源自网友分享截图）#瑞士卷消费降级#瑞士卷消费降级,0,2,0,0
340,-1,5.1E+15,3051949107,兰州微导航,【已出现“人传人”！#吃几个瑞士卷成老公们的必答题#】#瑞士卷怎么分#近日，“我可以吃几个瑞士卷？”成为女生们问她们老公最多的一个问题。事情的起因是，一个宝妈买了8个瑞士卷，女儿2个，儿子2个，老公2个，最后剩2个宝妈想吃，结果老公一顿教育，要宝妈懂事点，把瑞士卷留给孩子吃！宝妈感叹她不配吃瑞士卷，太卑微了！这一事件引发女网友们的讨论，于是，她们纷纷拷问自己的老公：咱们家瑞士卷怎么分？你怎么看待这件事呢？一起讨论~@南方日报（图片源自网友分享截图）#瑞士卷消费降级#瑞士卷消费降级,5,4,0,5
341,-1,5.1E+15,7194896200,骑叔荡天涯,#瑞士卷怎么分#最近，大家肯定都被一个“瑞士卷”的视频刷屏了吧？就是一个宝妈想吃剩下的瑞士卷，结果被老公一顿训，说她不爱孩子。这视频一下子就火了，宝妈孙菲菲也因为这事儿涨了好几万粉。说实话，刚开始看到这视频的时候，我真是气死了！这都什么年代了，吃个瑞士卷还得看老公脸色？孙菲菲那句“我连吃蛋糕的权力都没了”真是说到我心坎儿里去了。但这事儿吧，红得太快了，就容易引起争议。果然，没多久，就有人开始质疑这视频是不是摆拍，是不是为了博眼球、赚流量。还有人说，这跟去年的榴莲事件一样，都是挑起男女对立，然后坐收渔翁之利。孙菲菲一开始没回应这些质疑，可能也是没想到事情会闹这么大。但网络上的键盘侠们可不管那么多，直接开始网暴，说她怎么怎么样。这谁受得了啊？终于，在11月3日，孙菲菲出来说话了。她把那些跟“瑞士卷”有关的视频全删了，还自曝自己患抑郁症已经5年。她说，自己一直过得不开心，现在正在努力调整心态。哎，说实话，看到这儿我挺心疼她的。不管那视频是真是假，她受到的网暴都是真的。那些键盘侠们可能觉得自己只是说了几句话而已，但对孙菲菲来说，那可能就是压垮她的最后一根稻草。这事儿也给我们提个醒儿：网络世界虽然虚拟，但伤害却是真实的。我们在发表言论之前，真得好好想想，自己说的话会不会对别人造成伤害。最后，我想说：孙菲菲，加油！希望你能早日走出阴霾，找到属于自己的幸福。还有那些正在经历网暴的朋友们，也请你们坚强起来，不要被那些负面言论所影响。记住，生活总会好起来的！,20,0,2,22
342,-1,5.1E+15,1787526981,飞虎合肥,盒马永远站在热度前沿，所以一盒8个瑞士卷该怎么分？,0,0,0,0
343,-1,5.1E+15,1195306707,毛发医生钟飞,#瑞士卷怎么分##瑞士卷怎么分别成为第二个秦朗丢作业##瑞士卷消费降级#看到有人说，之前是吃榴莲、吃草莓尖尖、买化妆品来测试自己老公到底爱不爱自己，今年消费降级成了瑞士卷。,0,0,0,0
344,-1,5.1E+15,2794502910,捡了块肥皂,#瑞士卷怎么分#瑞士卷是啥东西我只知道包子饺子大馒头，馍馍花卷烙大饼,0,0,0,0
345,-1,5.1E+15,7879989470,SUN_闰土数码,#瑞士卷怎么分#分什么分，我全吃了谁都不给就很奇怪这种话题都能热搜……,4,3,0,4
346,-1,5.1E+15,5649170494,兰州微播,#别掉进8个瑞士卷怎么分的话题陷阱#看到一个博主对瑞士卷事件的观点分享，觉得很有道理。拿瑞士卷怎么分这个问题问自己的伴侣其实没什么意义，吃多少的选择权在自己，在于自己有没有经济独立的能力。L循环信昊的微博视频,1,1,0,1
347,-1,5.1E+15,1761823392,小等等de造奶机,给你们分享一个武汉的秋天�今年咋还不冷？一直可以穿单衣，这是我过过最长的秋天了#瑞士卷怎么分#没想到瑞士卷的话题讨论这么热烈。什么“消费降级”，什么“自我意识屈从”，什么“委屈的爱”……我觉得不管是谁，只要是用自己的能力买任何东西都可以不需要经过别人的同意。自己喜欢就尽力满足自己。能力不够的话那自然就需要考虑别人的态度和行为。说白了，如果我没吃你家大米/你买的大米，你就没资格管我。,13,12,0,13
348,-1,5.1E+15,3051949107,兰州微导航,#别掉进8个瑞士卷怎么分的话题陷阱#看到一个博主对瑞士卷事件的观点分享，觉得很有道理。拿瑞士卷怎么分这个问题问自己的伴侣其实没什么意义，吃多少的选择权在自己，在于自己有没有经济独立的能力。L循环信昊的微博视频,1,4,0,1
349,-1,5.1E+15,7454600726,我见青山多可笑,#吃几个瑞士卷成老公们的必答题#经济下行的……都绷不住了……丢人啊！有时候真的完全理解不了：成天拼命宣传中国普通家庭这样穷困潦倒，等级森严，阶级固化到铁板一块，到底有什么好处？我看了直担心，今年第三产业到底要沦落到什么地步……须知接近一半的就业都靠第三产业啊！如果普通家庭已经连“怎么分几块瑞士卷”都能成为大众最关心的话题……这个年，难过啊！～,94,6,8,102
350,-1,5.1E+15,2293544644,亨利KING自动车,#瑞士卷怎么分席卷全网老公#尼玛，什么狗屁热搜，瑞士卷限量供应？还是一盒万八千？买不起？一家子人，非为这两个瑞士卷纠结。男的鸡贼，女的矫情。老公不让吃就塞他嘴里，自己再买一盒不就完了？,12,0,1,13
351,-1,5.1E+15,5480412715,兰州微事,【已出现“人传人”！#吃几个瑞士卷成老公们的必答题#】#瑞士卷怎么分#近日，“我可以吃几个瑞士卷？”成为女生们问她们老公最多的一个问题。事情的起因是，一个宝妈买了8个瑞士卷，女儿2个，儿子2个，老公2个，最后剩2个宝妈想吃，结果老公一顿教育，要宝妈懂事点，把瑞士卷留给孩子吃！宝妈感叹她不配吃瑞士卷，太卑微了！这一事件引发女网友们的讨论，于是，她们纷纷拷问自己的老公：咱们家瑞士卷怎么分？你怎么看待这件事呢？一起讨论~@南方日报（图片源自网友分享截图）#瑞士卷消费降级#瑞士卷消费降级,0,4,0,0
352,-1,5.1E+15,2695492057,回忆到昨天,#瑞士卷消费降级#瑞士卷引发的人生思考；两个瑞士卷，夫妻两人+孩子三个人怎么分，难道不应该提现一下母爱、父爱吗？直接给孩子就可以啦！还有第二种情况，孩子是多余的，夫妻俩才是真爱，不分给孩子！第三种情况提醒父爱和对爱人的尊重，直接给孩子和妻子吧，毕竟他们是家庭的弱者！感觉不管什么情况，最终让我们反思的是，为啥要用两个瑞士卷去考验一家人，还记得一个典故二桃杀三士，就是利用三人的好胜心拿下了他们,16,12,0,16
353,-1,5.1E+15,5809057042,承包笑点,#瑞士卷消费降级#最近，网上流传着一种新奇的测试方式：用瑞士卷来检验另一半的爱意。在消费降级的大环境下，这一看似不起眼的甜点竟然成了家庭情感测试的“新武器”。对此，我有着自己的一些看法。首先，这样的测试方式本身就带着几分戏谑和无奈。在物质充裕的时代，我们或许可以通过购买昂贵的礼物或享受高端的服务来体验生活的美好。但如今，随着消费观念的转变和经济压力的增大，人们开始更加注重实用性和性价比。瑞士卷作为一种价格适中、口感不错的甜点，自然成了不少家庭的选择。然而，将它与爱情测试挂钩，却显得有些牵强和片面。#瑞士卷怎么分别成为第二个秦朗丢作业#,9,7,7,16
354,-1,5.1E+15,1743965223,马妍,#瑞士卷怎么分#这个小小的分瑞士卷事件，虽然有可能就是炒作，但这也揭示了生育后女性在家庭中的地位和待遇问题。在很多家庭中，女性生育后往往被赋予了更多的责任，需要照顾孩子的饮食起居，关注孩子的成长和教育。然而，与此同时，她们自己的需求和感受却常常被忽视。这次的瑞士卷事件，就是抓住了广大全职妈妈的痛点，所以才能引起这么大的关注。事实上，艺术来源于现实，这种不平等的现象不仅存在于这一个家庭中，而是具有一定的普遍性。因此，我们需要重新审视家庭关系中的权力与责任分配。每个人都应该被平等对待，无论是孩子还是成年人。当然，瑞士卷背后的炒作等问题，那就是另一件事儿了。#瑞士卷背后#,42,66,55,97
355,-1,5.1E+15,1985618477,乔小夏,#瑞士卷怎么分##贪吃鬼的美食节##微博尝鲜计划#JOJO小乔吃喝玩乐超话�瑞士卷是吧～姐妹你还想吃什么，到我这来，我这应有尽有，这辈子的瑞士卷都管够，我不光有瑞士卷，我还有蓝莓乳酪蛋糕，流心巧克力熔岩蛋糕，流心巴斯克，水果蛋挞，紫薯芋泥蛋糕，芝士蛋糕，抹茶蛋糕，玛格丽特黑松露披萨，你喜欢吃啥你说？管够～�麻辣烫是吧～有人跟我说这种话，我反手吃不完的瑞士卷丢给狗全吃了，麻辣烫吃剩下的放凉，嚯嚯喂猪了，没有猪的姐妹每天点三次，剩下吃不完的直接倒垃圾桶，每天当面重复三次，直到对方发狂�答应我，放下个人素质，享受缺德人生，拒绝精神内耗，有事直接发疯，与其委屈自己，不如为难别人���,3932,781,2572,6504
356,-1,5.1E+15,5985166710,嗨兰州,【已出现“人传人”！#吃几个瑞士卷成老公们的必答题#】#瑞士卷怎么分#近日，“我可以吃几个瑞士卷？”成为女生们问她们老公最多的一个问题。事情的起因是，一个宝妈买了8个瑞士卷，女儿2个，儿子2个，老公2个，最后剩2个宝妈想吃，结果老公一顿教育，要宝妈懂事点，把瑞士卷留给孩子吃！宝妈感叹她不配吃瑞士卷，太卑微了！这一事件引发女网友们的讨论，于是，她们纷纷拷问自己的老公：咱们家瑞士卷怎么分？你怎么看待这件事呢？一起讨论~@南方日报（图片源自网友分享截图）#瑞士卷消费降级#瑞士卷消费降级,5,6,0,5
357,-1,5.1E+15,6019625657,鑨髰王叁,53岁陈女士，离婚后被一个退休金5000的男人追求，但陈女士说：“搭伙过日子可以，领证就算了！”男人却说：“50多岁还能找个退休金5000多的男人，你就知足吧！要不是看你还有几分姿色，还真轮不到你！”陈女士丈夫在她40岁那年和一个女同事好上了，那时陈女士坚决要离婚，但丈夫极力挽留，他说：“我真的知错了，你不原谅我，也看在儿子的份上，就算要离婚也要等他长大成家立室再离啊！”丈夫见陈女士态度坚决，想来一个缓兵之计。陈女士果然被说服了，之后似乎是把这事忘了，像没事人一样，一直到儿子在她50岁退休那年成了家，陈女士才突然又提出和丈夫离婚，因为10年来陈女士都没再提过离婚，所以丈夫以为她已经原谅了自己，或者忘记那事了，结果没想到她竟然记到现在，没办法之下，他们只好离了婚。其实陈女士丈夫除了那次做了对不起她的事之外，其它都挺好的，但陈女士是一个特别爱憎分明的人，而且报复心特别强。当时不离婚只是不希望儿子受到影响，好在儿子在她精心教育下，也成功上了一所不错的大学，如今出来社会也找到了一份满意的工作，这才让陈女士觉得有点欣慰。见儿子学业有成，也组建了他自己的家庭了，这时做母亲的陈女士，觉得自己就算和丈夫离婚，也不会给儿子带来太大的伤害了。加上陈女士自己也退休了，所以才在50岁那年，还跟丈夫去离了婚，她打算以后的人生也好好替自己活一番。跟丈夫离婚后，不用再伺候公婆，也不用每天回到家就忙活家务和一日三餐，陈女士过上了一种很舒心的自由身的生活，整个人都看起来气色好多了。陈女士现在虽然53岁了，但身体保持得很不错，不知道她真实年龄的人，都说她看起来只有40多岁，知道她和丈夫离了婚，好几个朋友都主动给她介绍对象。陈女士跟这些帮忙介绍对象的朋友说：“你们就不要再给我介绍对象了，我也不打算再婚了的，现在一个人生活都不知道有多舒心……”可那些朋友就是不听，依然经常给陈女士介绍对象，不过，这些对象里面，确实有一个单身的男人，各方面条件都不错，但他跟陈女士交往，是奔着两人领证去的。陈女士一开始就明确地告诉了对方，她说“我们之间做朋友可以，但我不想再婚了，也不想掺和对方的家庭……”男人起初也说没问题，就先由做普通朋友开始，在了解之后，陈女士知道：男人56岁，退休金近5000元，看起来身体状况很不错，上一年和前妻离婚了，他跟80岁老母亲住在一起，儿子、儿媳妇和5岁的孙子也同住……两人做朋友期间都相处得挺好的，所以男人就明确表态说：“嫁给我吧！我是真心喜欢你的，在一起之后，我每个月5000元的退休金都交给你保管……”男人满心欢喜，他以为自己这么有诚意，陈女士一定会马上答应的。不料，陈女士思索片刻之后，却很认真地跟他说：“这段时间相互了解下来，我们暂时也确实处得挺不错的，但是搭伙过日子可以，要是领证就算了吧！我可不想嫁去你家照顾你们一家人！”男人说：“我都承诺把自己的退休金给你，你还不满意？50多岁还能找个退休金5000多的男人，你就知足吧！要不是看你还有几分姿色，还真轮不到你！”最后，因为陈女士不同意跟男人去领证，男人就选择了和她分开了，还在背地里跟介绍他们认识的朋友说：“连领证都不愿意的女人，她一定不是顾家的好女人，我看她一定还有其他男人，你也别帮她介绍了……”这话传到陈女士的耳边，她觉得男人这是在摸黑她，当初没同意跟他去领证是正确的选择，要是领证了，伺候婆婆和帮带男人的孙子，就会是自己的命运。后来，陈女士也跟介绍人说：“你怎么介绍了这么一个男人给我，每次行事都不尽兴，草草了事，太无能了！”因为这事，男人就变成了大家的笑柄，这把他气得半死，关键是他们根本没试过啊，可是越解释就越解释不清，所以只好默默背了这口锅。陈女士是一个爱憎分明的人，在丈夫和女同事好上之后，就坚决要离婚，只是碍于儿子的影响才暂时搁置，结果10年过去，她仍然记得，而且坚决离婚。后来在朋友的介绍下，有一个条件不错的男人，陈女士觉得相处可以，但不能结婚，而男人的目的却是要找一个可以照顾他一家人的妻子，所以他们产生了矛盾。合不来之后，男人抹黑陈女士，陈女士爱憎分明，即使有损自己声誉也要还以颜色，确实是一个敢做敢为的人。#瑞士卷怎么分#,2,1,1,3
358,-1,5.1E+15,7625595296,JJSS的食堂,瑞士卷怎么分不知道。反正一个大概300大卡。8个的话，2400大卡，是一个成年女性两天的基础代谢。,90,13,16,106
359,-1,5.1E+15,5480412715,兰州微事,#别掉进8个瑞士卷怎么分的话题陷阱#看到一个博主对瑞士卷事件的观点分享，觉得很有道理。拿瑞士卷怎么分这个问题问自己的伴侣其实没什么意义，吃多少的选择权在自己，在于自己有没有经济独立的能力。L循环信昊的微博视频,0,0,0,0
360,-1,5.1E+15,6043311739,大兰州,【#瑞士卷事件博主删除视频#，#瑞士卷事件博主否认摆拍制造对立#】近日，一博主发布的“吃2个瑞士卷换来老公的一顿教育”吐槽视频，让“瑞士卷怎么分”持续引发热议。有网友顺势“拷问”起自己的甚至全天下的“老公”；也有网友怀疑是“剧本”，纯粹博取流量。目前，当事博主已删除视频，称不想继续传播负能量。但否认摆拍、搞男女对立。#别掉进8个瑞士卷怎么分的话题陷阱#,4,21,0,4
361,-1,5.1E+15,1766266385,严娜妍,#网信办将核实调查瑞士卷事件#【#有网友质疑瑞士卷事件是剧本#当地网信办：将核实调查】#当地网信办回应瑞士卷事件#10月底，一位全职宝妈博主在社交平台上发布了一条视频，记录了她和丈夫的一次争吵。一盒瑞士卷8个，女儿吃了2个，儿子吃了2个，丈夫吃了2个，博主认为剩下2个该自己吃，没想到蛋糕还没进嘴里，遭到了丈夫的一顿教训。该条视频引起了网络热议，有网友怀疑视频是一个剧本，为了挑起对立和矛盾博取流量，多半是编的。对此，博主在11月3日发文称，她和丈夫最近矛盾确实有点多，视频是真实的，因不想继续传播负能量，所以就删除了。因博主关闭了陌生人私信评论功能，红星新闻尝试联系她未能成功。记者看到，其多条视频IP地址在浙江，画面有浙江金华义乌市元素。记者随后联系上浙江金华市委网信办，互联网违法和不良信息举报中心工作人员表示，他们将对博主所述瑞士卷事件进行核实调查。#瑞士卷怎么分##一起来投票#L严娜妍的微博视频,8,0,0,8
362,-1,5.1E+15,7269002208,游戏动漫小兔娱,瑞士卷怎么分瑞士卷到底是什么梗事件瑞士卷，这一看似普通的甜点，在近期网络上掀起了一场风波，成为无数家庭讨论的焦点。事件的起因是一位全职妈妈分享的家庭小插曲：她购买了一盒八个瑞士卷，孩子们和丈夫各吃了两个，当她准备享用剩下的两个时，却遭到了丈夫的责备，认为她应该为孩子留下。这一事件迅速在网络上发酵，引发了广泛的社会关注和讨论。这位全职妈妈在忙碌了一天后，为自己买了八块瑞士卷作为小奖励。原本只是想在照顾孩子的间隙里，找到一丝慰藉和甜蜜，却没想到这一行为竟引发了家庭内部的争执。她的丈夫认为，作为母亲，她应该更多地考虑孩子的需求，而不是自己的口腹之欲。然而，这位妈妈却觉得，自己也有权利享受属于自己的那份甜蜜。这一争执被记录下来并上传至网络，迅速引发了广泛关注和热议。视频中的妈妈一脸无奈，而老公的态度则让人大跌眼镜。不少网友表示，这样的场景在家庭生活中并不罕见，但如此直白且缺乏尊重的表达方式，确实让人感到心寒。全职妈妈们的付出与辛劳，往往因为日常琐碎而被忽视，甚至被当作理所当然。这根小小的瑞士卷，仿佛成了家庭地位与情感尊重的试金石。随着视频的持续发酵，这场风波逐渐演变成了一场全网范围内的“甜蜜”考验。无数已婚女性开始询问自己的老公对这件事的看法，试图从他们的回答中窥探出自己在家庭中的地位与分量。这一举动让已婚男士们压力倍增，纷纷在社交媒体上晒出自己的“答卷”，有的幽默风趣，有的则略显尴尬。这场考验不仅让网友们看到了已婚男士们的幽默与智慧，更让他们感受到了家庭中的温暖与包容。尽管每个人的回答各不相同，但那份对家庭的责任感和对妻子的关爱，却是共同的底色。有的老公表示：“老婆想吃多少就吃多少，我负责赚钱养家，她负责貌美如花。”有的则略显紧张地回复：“我觉得这事儿得看你心情，你高兴就好。”更有一些老公直接“投降”，表示：“我以后一定注意言行举止，绝不让老婆受半点委屈。”这场风波背后，折射出的是家庭成员之间的地位不平等问题。在传统的家庭观念中，妻子往往被视为家庭的附属品，需要为家庭付出一切，包括牺牲自己的需求和欲望。然而，随着社会的进步和女性地位的提高，这种观念已经逐渐被打破。现代家庭应该是一个平等、和谐、互相尊重的集体，每个家庭成员都应该有自己的权利和地位。此外，这一事件也引发了人们对于夫妻之间沟通和理解的思考。在婚姻中，沟通和理解是非常重要的。,20,25,23,43
363,-1,5.1E+15,5985166710,嗨兰州,#别掉进8个瑞士卷怎么分的话题陷阱#看到一个博主对瑞士卷事件的观点分享，觉得很有道理。拿瑞士卷怎么分这个问题问自己的伴侣其实没什么意义，吃多少的选择权在自己，在于自己有没有经济独立的能力。L循环信昊的微博视频,5,8,0,5
364,-1,5.1E+15,2036161077,马上谈,#网信办将核实调查瑞士卷事件#是该好好查一查！但夫妻俩的事官方该如何核实呢？很为难…唯一可以介入的，可能就是这张图中的线索了。5月份时，该博主还在说前夫哥多么多么好，然后几个月后，就和现在的老公争吵瑞士卷该怎么分…我个人认为这应该是摆拍的。#有网友质疑瑞士卷事件是剧本##当地网信办回应瑞士卷事件#,84,15,8,92
365,-1,5.1E+15,1582199901,半个空中飞人,如果不干预的话，那个瑞士卷的话题估计会往带货的方向演变：1、小视频炒作瑞士卷在家里该怎么分，全网推全网讨论。2、然后下一个话题就会变成怎么样的瑞士卷才是好吃的瑞士卷，什么氢化奶油不健康、重糖重油不健康来一波。3、接着图穷匕见，全网热议某S记开头的仓储超市瑞士卷最有性价比，纯正动物奶油，轻糖不会齁甜，而且分量很足，再也不用担心家里不够分了。4、然后公关团队找S超市结账。PS：我也不知道S超市是哪家，我随便写的，既可以是S超市，也可以是B超市，欢迎对号入座。,180,26,18,198
366,-1,5.1E+15,5440172830,宝鸡微直播,【已出现“人传人”！#吃几个瑞士卷成老公们的必答题#】#瑞士卷怎么分#近日，“我可以吃几个瑞士卷？”成为女生们问她们老公最多的一个问题。事情的起因是，一个宝妈买了8个瑞士卷，女儿2个，儿子2个，老公2个，最后剩2个宝妈想吃，结果老公一顿教育，要宝妈懂事点，把瑞士卷留给孩子吃！宝妈感叹她不配吃瑞士卷，太卑微了！这一事件引发女网友们的讨论，于是，她们纷纷拷问自己的老公：咱们家瑞士卷怎么分？你怎么看待这件事呢？一起讨论~@南方日报（图片源自网友分享截图）#瑞士卷消费降级#瑞士卷消费降级,2,2,0,2
367,-1,5.1E+15,6050877201,卷心菜剧综,瑞士卷怎么分，分的是瑞士卷吗？不是，是你对你的配偶的在乎，也是你对你需要的东西的主动权，吃个瑞士卷还要问别人分不分给你，这样的家庭，宝妈，家庭主妇，他们的处境是社会应该关心的问题，也是女人自己应该关心的解决的问题，没有收入当家庭主妇的结果,7,9,0,7
368,-1,5.1E+15,5979629331,五桶工坊,正常人谁没事吃个瑞士卷还得拍视频呀？不就是故意找事吗？#瑞士卷怎么分##网信办将核实调查瑞士卷事件#【#有网友质疑瑞士卷事件是剧本#当地网信办：将核实调查】#当地网信办回应瑞士卷事件#10月底，一位全职宝妈博主在社交平台上发布了一条视频，记录了她和丈夫的一次争吵。一盒瑞士卷8个，女儿吃了2个，儿子吃了2个，丈夫吃了2个，博主认为剩下2个该自己吃，没想到蛋糕还没进嘴里，遭到了丈夫的一顿教训。该条视频引起了网络热议，有网友怀疑视频是一个剧本，为了挑起对立和矛盾博取流量，多半是编的。对此，博主在11月3日发文称，她和丈夫最近矛盾确实有点多，视频是真实的，因不想继续传播负能量，所以就删除了。因博主关闭了陌生人私信评论功能，红星新闻尝试联系她未能成功。记者看到，其多条视频IP地址在浙江，画面有浙江金华义乌市元素。记者随后联系上浙江金华市委网信办，互联网违法和不良信息举报中心工作人员表示，他们将对博主所述瑞士卷事件进行核实调查。L五桶工坊的微博视频,56,12,1,57
369,-1,5.1E+15,6572756723,半程KeMeng,全职宝妈吃两个瑞士卷被丈夫指责，全网老公接受“灵魂拷问”。“一波三折CPU差点干烧了”。#瑞士卷怎么分#L半程KeMeng的微博视频,21,5,2,23
370,-1,5.1E+15,6043311739,大兰州,【#瑞士卷怎么分当事博主回应#】#瑞士卷怎么分当事博主否认摆拍#近日，“瑞士卷怎么分”议题火遍全网，引发大量讨论。事情的起因是一位全职宝妈发布了这样一条视频：宝妈买了8个瑞士卷，女儿吃了2个，儿子吃了2个，老公吃了2个。夜深孩子们都睡了以后，她认为剩下2个瑞士卷该自己吃，没想到遭到了老公的批评。11月4日，事件当事博主回应称，视频是真实的，删除是因为负能量太多了，看着都压抑，不想继续传播下去。#8个瑞士卷宝妈吃几个不自私#L长江云新闻的微博视频,7,19,0,7
371,-1,5.1E+15,7747422373,The视界,#瑞士卷怎么分#全国男人一听见瑞士卷撒腿就跑LThe视界的微博视频,6,3,0,6
372,-1,5.1E+15,3973074376,苏娅mini空间,昨天我刷到好多关于“瑞士卷怎么分”的段子，然后我就给白先生看，我们还讨论了一会。在我家这边，真的不会出现这个问题，不管是我爷爷家还是我姥姥家，都是差不多，基本上都是女人当家，管家，除非是女人自己不想管。我父母就很夸张，比如买水果，我父亲会给我母亲买特别贵的，特别好的，然后给自己买一般的。在我家那就更不用说了，就像白先生总说的一句话：“你要是不开心，全家都遭殃。”可以说东北大部分都这样吧，本身就很少会重男轻女，基本上是男女平等，甚至会出现重女轻男的情况。一般在家里要是出现好吃的或是比较贵的食物，那一定是母亲和孩子的，而且也不限于吃的东西，就买衣服购物这方面也是一样，有钱都先紧着家里的女人花。比如我和我母亲可以买一件衣服好几千，但我父亲和白先生就可能是买几百块的，大概是这么个状态。所以我一开始看到“瑞士卷”的热搜，我都没当回事，直到我昨天一直刷到其他博主拍的“瑞士卷”测试视频，我才去看“瑞士卷”的原视频，真的是让我大跌眼镜！！！确实是想象不到，看得我和白先生直呼“不如离婚，自己过，也不至于如此憋屈啊”。而且这跟消费降级没有什么关系吧，一个瑞士卷普通的，不是私房网红牌子的，差不多几块钱一个，这说到底就是不在乎罢了！ps：当然这也有可能是段子，不过我也希望这是段子，是假的，这样的话至少这位母亲不会真的这么惨，连吃两个普通的小蛋糕都不能吃。#瑞士卷消费降级##瑞士卷##别掉进8个瑞士卷怎么分的话题陷阱##瑞士卷怎么分#,29,14,0,29
373,-1,5.1E+15,2385754614,我是律师的朋友,#网信办将核实调查瑞士卷事件##瑞士卷怎么分#有网友、专家已经开始质疑这个话题的背后有敌对势力参与策划，对我们生育大局、家庭和谐造成恶劣影响，恶意引导恐婚、恐生的舆论氛围。我个人估计哪里那么多敌对势力，无非就是家长里短而已。每个家庭都有追求幸福的权利，#何不吃肉糜#的话很多人都会问，但家庭不如意常八九。无论如何，经济形势下行大背景下，夫妻齐心，和谐奋进，共同创造更为美好的明天。祝您幸福。,1,1,0,1
374,-1,5.1E+15,1796445350,锋潮科技,8个瑞士卷怎么分事件，有人觉得这不是剧本啊……,435,105,11,446
375,-1,5.1E+15,2264635847,一都阿叔,#网信办将核实调查瑞士卷事件#"8个瑞士卷怎么分？"引热议，成为全网老公必考题，原博主删除视频并否认摆拍制造对立，网友评：别成为第二个秦朗丢作业。你认为这个视频是真实的还是摆拍吗？,156,2,4,160
376,-1,5.1E+15,5649170494,兰州微播,【评论丨#别掉进8个瑞士卷怎么分的话题陷阱#】#瑞士卷怎么分别成为第二个秦朗丢作业#“8个瑞士卷怎么分？”近日，相关词条冲上了热搜。据报道，这个问题源自一女子在网络上发布的一则视频。视频记录了她与老公的一次争吵：家里买了一盒瑞士卷，总共8个，女儿吃了2个，儿子吃了2个，老公吃了2个。夜深孩子们都睡了以后，她拿出剩下的2个瑞士卷自己吃，还没进嘴里，就遭到了老公的一顿批评，理由是家长应多以身作则多吃正餐少吃零食，而且如果妈妈吃了，孩子就没得吃了。初看这个问题，还以为是一道数学题。仔细一看，原来是道“伦理题”。视频中女子感叹，原来自己已经卑微到连自主吃一个小蛋糕的权利都没有了。在网传的视频配文中，她提及和女儿说起想和丈夫离婚时，女儿小小的身体哭得发抖，于是她就只能妥协了。理性地说，有两种可能，一是这条视频记录的是真事。生活中，有的夫妻就是容易因为生活琐事而产生较大的争端，甚至因饭菜不合口味、因谁来做饭而吵到家庭“崩盘”的案例也有不少。当然，也有一种可能，视频内容只是一个段子。正如一些网友怀疑这多半是编的，就是为了挑起对立和矛盾来博取流量。无论事件性质如何，旁人都不妨把它当成一段网络“花絮”看待就好。正应了这句话，一旦把“花絮”当成严肃话题，不仅正襟危坐地“做题”，还陷入牛角尖，甚至影响到自己的价值判断和家庭稳定，那就属于别人挖坑自己跳了。确实，谁都有权利评判一件事，且谁也无法预料自己的一次点击会成为网络海啸的一份力量，但须知，“秦朗巴黎丢作业”的殷鉴不远，点到为止，远离“话题撕裂”，不扩大，不伤人，也是一种有意义的理性。O评论丨别掉进“八个瑞士卷怎么分”的话题陷阱,0,1,0,0
377,-1,5.1E+15,3051949107,兰州微导航,【评论丨#别掉进8个瑞士卷怎么分的话题陷阱#】#瑞士卷怎么分别成为第二个秦朗丢作业#“8个瑞士卷怎么分？”近日，相关词条冲上了热搜。据报道，这个问题源自一女子在网络上发布的一则视频。视频记录了她与老公的一次争吵：家里买了一盒瑞士卷，总共8个，女儿吃了2个，儿子吃了2个，老公吃了2个。夜深孩子们都睡了以后，她拿出剩下的2个瑞士卷自己吃，还没进嘴里，就遭到了老公的一顿批评，理由是家长应多以身作则多吃正餐少吃零食，而且如果妈妈吃了，孩子就没得吃了。初看这个问题，还以为是一道数学题。仔细一看，原来是道“伦理题”。视频中女子感叹，原来自己已经卑微到连自主吃一个小蛋糕的权利都没有了。在网传的视频配文中，她提及和女儿说起想和丈夫离婚时，女儿小小的身体哭得发抖，于是她就只能妥协了。理性地说，有两种可能，一是这条视频记录的是真事。生活中，有的夫妻就是容易因为生活琐事而产生较大的争端，甚至因饭菜不合口味、因谁来做饭而吵到家庭“崩盘”的案例也有不少。当然，也有一种可能，视频内容只是一个段子。正如一些网友怀疑这多半是编的，就是为了挑起对立和矛盾来博取流量。无论事件性质如何，旁人都不妨把它当成一段网络“花絮”看待就好。正应了这句话，一旦把“花絮”当成严肃话题，不仅正襟危坐地“做题”，还陷入牛角尖，甚至影响到自己的价值判断和家庭稳定，那就属于别人挖坑自己跳了。确实，谁都有权利评判一件事，且谁也无法预料自己的一次点击会成为网络海啸的一份力量，但须知，“秦朗巴黎丢作业”的殷鉴不远，点到为止，远离“话题撕裂”，不扩大，不伤人，也是一种有意义的理性。O评论丨别掉进“八个瑞士卷怎么分”的话题陷阱,2,7,0,2
378,-1,5.1E+15,5696578309,北途川,#瑞士卷怎么分#问题不在于怎么分，在于权力掌握在谁手上如果掌握在自己手上，哪怕一个不分给自己，你都会感觉到舒适，因为全部分出去，一定有你自己的考量，你是掌握着解释权的。互联网有时候挺魔幻的。前一阵还在赞扬庆奶大女主，最近又开始分瑞士卷了。这两件事的主题是完全相悖的。庆奶的核心是“主体性”，我是我人生的绝对主角，而问对方一盒瑞士卷怎么分，是把分配权交给别人，而自己作为被动承接方，就算能分到一整盒，真的就开心了吗。不要在乎它怎么分，要去抢夺它的支配权。,60,9,0,60
379,-1,5.1E+15,1825826417,李大柱之冠,#瑞士卷怎么分#所谓家丑不可外扬，正常人类，谁会在吃零食的时候拍视频？拍视频就拍视频，正好能还能拍到矛盾点？我宁愿相信秦始皇。,5,0,1,6
380,-1,5.1E+15,2661992301,买家张俊,#网信办将核实调查瑞士卷事件#但凡上过三天网的人，都能看出这个就是摆拍炒作！你半夜哄完孩子睡觉之后，打开手机摄像头来拍自己吃瑞士卷，刚好被你老公发现，还拍下了跟你老公雷人的对话？婆媳矛盾、夫妻矛盾一直都是流量密码，就是这些视频宣传对立以后，能引起一些人的共鸣，涨粉之后开启直播带货。如果不管的话，那互联网将充斥着这样的摆拍内容！#瑞士卷怎么分#L买家张俊的微博视频,81,56,72,153
381,-1,5.1E+15,1685631765,柳叶安安,#瑞士卷怎么分#这条热搜后直播间的瑞士卷都卖爆了我明天就和老W拍一条视频，一个含辛茹苦的老母亲，生病了，她想吃“等江南的糕点”，老公不愿给她买，还给她一杯凉开水，叫她凑合凑合得了,183,21,2,185
382,-1,5.1E+15,1185441660,某顺,《瑞士卷考糊智商》“瑞士卷怎么分”的视频，各位刷到没？某顺我是刷到了，而且刷到了原视频，和不少女人用“我该不该吃瑞士卷”一题，来考核自家男人的“模拟卷”视频。原视频是一个男人埋怨老婆吃了孩子爱吃的瑞士卷。女人义愤填膺地一连串反问，主题是“我为什么没资格吃瑞士卷？”。此视频在网上引起一波“家庭和谐”的女人纷纷效仿，她们依水瓢画葫芦，拍视频自证自家男人有多么懂事和爱自己。貌似瑞士卷这个考题，已和“我跟你妈都掉水里，你救谁”一样，沦为不讲理的致命题了。但某顺我却想替原视频里那个“男坏蛋”说句公道话——当你家正过着捉襟见肘的日子，瑞士卷也成为你家的奢侈享受时，身为父母的你和你配偶，可不就是“都会把孩子爱吃的留给孩子吃”嘛。难道你家不是这样的？或者你家传统一直是大人吃好的、孩子吃不好的？我怎么不大信呢？除非你家孩子不是你亲生的吧，不然亲生的娃爱吃的食物，亲妈一般都会说“我不爱吃”，亲爸也会说“我不吃”。当然，有些人天生没有骨血情结，ta也可能只顾自己、不顾孩子。但，如此冷漠理智的原生家庭，和“父母不爱我”的感受，不是最被你们不齿的吗？可能有人会说了，某顺你咋知道人家日子捉襟见肘呢！关于这点咱真不用抬杠，她家真富裕的话，她吃多少个瑞士卷，她男人也会选择视而不见。那就没原视频了。原视频的女人因为男人不爱自己，才借瑞士卷发挥“自己没有家庭地位”的不满。跟风做视频的那些女人家庭地位肯定都不低，不然她们男人会配合她们拍视频、还让发网上？感情不好的夫妻，互相出言不逊都是小意思，更普遍的是互相视对方是死人、但凡搭腔也是为孩子，哪个还会配合你演戏呦。能出镜的都是感情尚好的夫与妻。所以，瑞士卷这题，考的不是那些个男人，而是观众的智商。谁当真谁就又被骗了。即便原视频可能也是“演段子”、有挑逗男女对立之嫌，某顺还是想劝那些跟风模拟考男人立场的女人们：就算男人从不吝啬女人你吃什么、你为自己买了什么，也未必就是他爱你。男人对自己老婆，即便没爱了，也不会多么吝啬，毕竟老婆现在以后都是伺候自己的人呢，男人又不傻。再说了，平时他什么家务都指望你，天天懒得像死驴一样横尸家中、就等着你伺候他，这样的男人就算随便你吃多少瑞士卷，你又多幸福啊？！,33,6,0,33
383,-1,5.1E+15,6043311739,大兰州,【#瑞士卷怎么分席卷全网老公#】这两天，“瑞士卷怎么分”应该已经成为每一位老公的必考题了。#8个瑞士卷宝妈吃几个不自私#事情的起因得追溯到一条相当气人的视频，10月28日，一位全职宝妈在社交平台上发布了一条视频。视频的内容记录了她与老公的一次争吵，争吵的原因简单到你难以想象。宝妈当天买了一盒瑞士卷，总共8个瑞士卷，女儿吃了2个，儿子吃了2个，老公吃了2个。夜深孩子们都睡了以后，她自然认为剩下2个瑞士卷该自己吃，没想到蛋糕还没进嘴里，却遭到了老公的一顿批评。至于为什么不让吃，她老公给出的理由是：①他认为瑞士卷是零食，自己老婆应该吃饭的时候多吃饭，这样才算给孩子们当榜样，而不是晚上吃零食。②他认为，瑞士卷他老婆吃了，孩子就没得吃了，所以吃瑞士卷是自私的行为。一顿话下来把老婆都气无语了。当初是你让我当全职妈妈的，现在却吃个蛋糕都要管东管西。结果，老公根本没想着去听宝妈的话，反手就是否认三连，把一句“你又想多了”扣在宝妈头上。在网友们愤愤不平的同时，“我可以吃几个瑞士卷”也成为了全网老公们的必考题。（脊梁in上海SH）,5,16,0,5
384,-1,5.1E+15,6893440069,吃成大饼脸,#瑞士卷怎么分#好家伙！头一次听说这名字，瑞士卷好不好吃�，最近有点挑食，她是不是在瑞士卷工厂上班，打广告呢？,9,4,0,9
385,-1,5.1E+15,6271238018,AAAA西山派代打师傅-为圈黄子韬,#瑞士卷消费降级#冷知识：正常人脸上是不会长摄像头的。抛开事实，这也深刻反映了无论女性还是得当自己的靠山，稳定的经济来源和坚持自我的底气。这才是重点。而不是像娇妻文学转头去问男人【瑞士卷怎么分？】,28,10,0,28
386,-1,5.1E+15,7804090034,栗子警告,#瑞士卷怎么分#瑞士卷怎么分,2,1,0,2
387,-1,5.1E+15,1811865445,韩语养乐多老师,#瑞士卷怎么分#这种视频我现在都默认是摆拍……100个里冤枉1个可能都说多了……,163,15,2,165
388,-1,5.1E+15,5480412715,兰州微事,【评论丨#别掉进8个瑞士卷怎么分的话题陷阱#】#瑞士卷怎么分别成为第二个秦朗丢作业#“8个瑞士卷怎么分？”近日，相关词条冲上了热搜。据报道，这个问题源自一女子在网络上发布的一则视频。视频记录了她与老公的一次争吵：家里买了一盒瑞士卷，总共8个，女儿吃了2个，儿子吃了2个，老公吃了2个。夜深孩子们都睡了以后，她拿出剩下的2个瑞士卷自己吃，还没进嘴里，就遭到了老公的一顿批评，理由是家长应多以身作则多吃正餐少吃零食，而且如果妈妈吃了，孩子就没得吃了。初看这个问题，还以为是一道数学题。仔细一看，原来是道“伦理题”。视频中女子感叹，原来自己已经卑微到连自主吃一个小蛋糕的权利都没有了。在网传的视频配文中，她提及和女儿说起想和丈夫离婚时，女儿小小的身体哭得发抖，于是她就只能妥协了。理性地说，有两种可能，一是这条视频记录的是真事。生活中，有的夫妻就是容易因为生活琐事而产生较大的争端，甚至因饭菜不合口味、因谁来做饭而吵到家庭“崩盘”的案例也有不少。当然，也有一种可能，视频内容只是一个段子。正如一些网友怀疑这多半是编的，就是为了挑起对立和矛盾来博取流量。无论事件性质如何，旁人都不妨把它当成一段网络“花絮”看待就好。正应了这句话，一旦把“花絮”当成严肃话题，不仅正襟危坐地“做题”，还陷入牛角尖，甚至影响到自己的价值判断和家庭稳定，那就属于别人挖坑自己跳了。确实，谁都有权利评判一件事，且谁也无法预料自己的一次点击会成为网络海啸的一份力量，但须知，“秦朗巴黎丢作业”的殷鉴不远，点到为止，远离“话题撕裂”，不扩大，不伤人，也是一种有意义的理性。O评论丨别掉进“八个瑞士卷怎么分”的话题陷阱,0,0,0,0
389,-1,5.1E+15,1888781280,星球之音,#瑞士卷怎么分#8个瑞士卷，一家4口平分，女子过日子认真到累，这是穷吗#说真话知真相#,1,3,1,2
390,-1,5.1E+15,1081273845,王小亚,#网信办将核实调查瑞士卷事件#觉得就像摆拍，精确拱火。现在家里都24小时监控吗，动不动就拿个视频出来挑家庭矛盾话题。不过话说回来所以还是要自己工作，不工作就是手心朝上看别人脸色，不是向父母讨饭就是向伴侣讨饭。瑞士卷都要网络升堂不管谁对谁错都觉得可悲。当然法律上夫妻财产共享，全职有功劳，但这种政治正确放在实际操作上意义不大。道理是对的，但怎么落实？离婚想带走孩子养得起吗？谁掌握生产资料谁就气势高一筹，现实债主都得哄着欠债的，公司里业务骨干都横着走领导也得哄着呢，到家庭里不也一样。何况普通人家存款都没多少呢本身也没啥婚后资产可分，法律判的赡养费才几个子？确实也有运气好找到有钱还完全给你自由花的父母或伴侣的，但这可不是标配，是幸运儿。何况其实还真不是全然自由，自己多少不能太不合对方的喜好和期待，但花自己钱就不一样了。,26,1,0,26
391,-1,5.1E+15,1633537680,地球镜头A,#瑞士卷怎么分#想多了，一些人智商降级而已,11037,10,0,11037
392,-1,5.1E+15,2562817551,英语学习精华,各种口味的“瑞士卷”的英文表达：原味瑞士卷（OriginalSwissroll）巧克力瑞士卷（ChocolateSwissroll）抹茶瑞士卷（MatchaSwissroll）咖啡瑞士卷（CoffeeSwissroll）草莓瑞士卷（StrawberrySwissroll）柠檬瑞士卷（LemonSwissroll）红丝绒瑞士卷（RedvelvetSwissroll）香芋紫薯瑞士卷（TaroandpurplesweetpotatoSwissroll）#瑞士卷怎么分#,11,1,3,14
393,-1,5.1E+15,5985166710,嗨兰州,【评论丨#别掉进8个瑞士卷怎么分的话题陷阱#】#瑞士卷怎么分别成为第二个秦朗丢作业#“8个瑞士卷怎么分？”近日，相关词条冲上了热搜。据报道，这个问题源自一女子在网络上发布的一则视频。视频记录了她与老公的一次争吵：家里买了一盒瑞士卷，总共8个，女儿吃了2个，儿子吃了2个，老公吃了2个。夜深孩子们都睡了以后，她拿出剩下的2个瑞士卷自己吃，还没进嘴里，就遭到了老公的一顿批评，理由是家长应多以身作则多吃正餐少吃零食，而且如果妈妈吃了，孩子就没得吃了。初看这个问题，还以为是一道数学题。仔细一看，原来是道“伦理题”。视频中女子感叹，原来自己已经卑微到连自主吃一个小蛋糕的权利都没有了。在网传的视频配文中，她提及和女儿说起想和丈夫离婚时，女儿小小的身体哭得发抖，于是她就只能妥协了。理性地说，有两种可能，一是这条视频记录的是真事。生活中，有的夫妻就是容易因为生活琐事而产生较大的争端，甚至因饭菜不合口味、因谁来做饭而吵到家庭“崩盘”的案例也有不少。当然，也有一种可能，视频内容只是一个段子。正如一些网友怀疑这多半是编的，就是为了挑起对立和矛盾来博取流量。无论事件性质如何，旁人都不妨把它当成一段网络“花絮”看待就好。正应了这句话，一旦把“花絮”当成严肃话题，不仅正襟危坐地“做题”，还陷入牛角尖，甚至影响到自己的价值判断和家庭稳定，那就属于别人挖坑自己跳了。确实，谁都有权利评判一件事，且谁也无法预料自己的一次点击会成为网络海啸的一份力量，但须知，“秦朗巴黎丢作业”的殷鉴不远，点到为止，远离“话题撕裂”，不扩大，不伤人，也是一种有意义的理性。O评论丨别掉进“八个瑞士卷怎么分”的话题陷阱,3,10,0,3
394,-1,5.1E+15,1299321623,鸩羽毒舞,马天宇超话#马天宇建议取消8个装瑞士卷#还是你带种有话就说，关于瑞士卷怎么分，他说卷个p，一个男人犯的错，全天下男人得考试，我建议取消8个装瑞士卷，看到唐山打人事件，他直接开炮，下次通报的时候直接带遗照吧，看到老师殴打学生，他说这是根坏，情绪不稳定，不适合当老师。有事他是真上啊，马天宇是真能处。L鸩羽毒舞的微博视频,42,30,1,43
395,-1,5.1E+15,7335979459,黄腿肠,刷到一个女生问她男朋友如果以后有孩子了八个瑞士卷怎么分，男的说我会拿出5个给我妈一个给我爸我跟你一人一个。然后女生又换着方式问了好几次，比如你为什么不能让你爸给你妈买，为什么你要把我的瑞士卷分给你妈，为什么你不能给你妈买一盒，如果结婚之后我你你妈住一起我自己买了一盒瑞士卷我能吃几个。男的全部向着他妈，说你有病是吗？矫情什么，我说不买了吗？你说我妈试试呢？我会向着我妈吵了几页聊天记录之后女的分手了。我看完这么一大堆只想说我好想撞墙，我受不了，我要尖叫。,7690,199,70,7760
396,-1,5.1E+15,5069980395,小布爱吃蛋挞,#8个瑞士卷宝妈吃几个不自私#为什么我首页会出现这么无语的问题？骂归骂，我还是忍不住问了三爷：八个瑞士卷咱们怎么分？三爷打游戏，头都不抬：都给你，我又不爱吃。我：这是热门讨论，你这个回答不够出彩。三爷沉思一秒：都给你，我一口不吃，儿子你看心情想给就给，不给我妈。我听到最后：？？？都不住一起，关你妈啥事？三爷：流量密码。,45,9,0,45
397,-1,5.1E+15,2150758415,孤烟暮蝉,瑞士卷事件的一些讨论是不是太上纲上线了？我个人认为，瑞士卷事件的视频就是剧本摆拍。谁家吵架的时候，还有心思架着摄像头摆好摄影角度开吵？两个瑞士卷，能值几块钱？一个有两个孩子，且女方为全职主妇的家庭，经济实力应该是挺好的。这样的家庭真的会因为剩下两个瑞士卷归谁吃吵起来吗？然而，就是这么个视频，却引发了滔天流量和反思党们的集体反思。有说女权的，有说婚姻中家庭主妇的付出和辛劳被社会无视的，有说男女在婚姻中对财产的话语权的。这些个针对瑞士卷事件的讨论，是不是太上纲上线了？诚然，这些问题在我们社会中不是不存在，讨论这些不是没有意义。但如果要讨论，也应该基于真实的事件，而不是这种“疑点重重”“疑似摆拍”的视频。只有20块钱，或者会因为1块钱怎么花，产生矛盾。有20万，怎么花100，根本就不是个矛盾点。网信办已经介入调查，如果被查明是剧本摆拍，这算不算故意挑动社会情绪，故意引发社会矛盾？即便瑞士卷事件是真实的，那这种情况也绝对属于个别现象，这对夫妻的矛盾，也绝不是因为几块钱的两个瑞士卷应该归谁吃所引发。个别现象和社会普遍现象，完全是两回事。#网友争论瑞士卷怎么分#,442,78,13,455
398,-1,5.1E+15,6043311739,大兰州,【已出现“人传人”！#吃几个瑞士卷成老公们的必答题#】#瑞士卷怎么分#近日，“我可以吃几个瑞士卷？”成为女生们问她们老公最多的一个问题。事情的起因是，一个宝妈买了8个瑞士卷，女儿2个，儿子2个，老公2个，最后剩2个宝妈想吃，结果老公一顿教育，要宝妈懂事点，把瑞士卷留给孩子吃！宝妈感叹她不配吃瑞士卷，太卑微了！这一事件引发女网友们的讨论，于是，她们纷纷拷问自己的老公：咱们家瑞士卷怎么分？你怎么看待这件事呢？一起讨论~@南方日报（图片源自网友分享截图）#瑞士卷消费降级#瑞士卷消费降级,6,17,0,6
399,-1,5.1E+15,7805609625,杭田视频,【评论丨#别掉进8个瑞士卷怎么分的话题陷阱#】#瑞士卷怎么分别成为第二个秦朗丢作业#“8个瑞士卷怎么分？”近日，相关词条冲上了热搜。据报道，这个问题源自一女子在网络上发布的一则视频。视频记录了她与老公的一次争吵：家里买了一盒瑞士卷，总共8个，女儿吃了2个，儿子吃了2个，老公吃了2个。夜深孩子们都睡了以后，她拿出剩下的2个瑞士卷自己吃，还没进嘴里，就遭到了老公的一顿批评，理由是家长应多以身作则多吃正餐少吃零食，而且如果妈妈吃了，孩子就没得吃了。初看这个问题，还以为是一道数学题。仔细一看，原来是道“伦理题”。视频中女子感叹，原来自己已经卑微到连自主吃一个小蛋糕的权利都没有了。在网传的视频配文中，她提及和女儿说起想和丈夫离婚时，女儿小小的身体哭得发抖，于是她就只能妥协了。理性地说，有两种可能，一是这条视频记录的是真事。生活中，有的夫妻就是容易因为生活琐事而产生较大的争端，甚至因饭菜不合口味、因谁来做饭而吵到家庭“崩盘”的案例也有不少。当然，也有一种可能，视频内容只是一个段子。正如一些网友怀疑这多半是编的，就是为了挑起对立和矛盾来博取流量。无论事件性质如何，旁人都不妨把它当成一段网络“花絮”看待就好。正应了这句话，一旦把“花絮”当成严肃话题，不仅正襟危坐地“做题”，还陷入牛角尖，甚至影响到自己的价值判断和家庭稳定，那就属于别人挖坑自己跳了。确实，谁都有权利评判一件事，且谁也无法预料自己的一次点击会成为网络海啸的一份力量，但须知，“秦朗巴黎丢作业”的殷鉴不远，点到为止，远离“话题撕裂”，不扩大，不伤人，也是一种有意义的理性O网页链接O评论丨别掉进“八个瑞士卷怎么分”的话题陷阱,2,2,0,2
400,-1,5.1E+15,5370248051,柚柚山里妹,#瑞士卷怎么分#家里买了6个瑞士卷，问胖胖怎么分？他的回答笑死我了，单纯的boy……#热门视频#L柚柚山里妹的微博视频,2,2,0,2
401,-1,5.1E+15,7805609625,杭田视频,【#瑞士卷怎么分当事博主回应#】#瑞士卷怎么分当事博主否认摆拍#近日，“瑞士卷怎么分”议题火遍全网，引发大量讨论。事情的起因是一位全职宝妈发布了这样一条视频：宝妈买了8个瑞士卷，女儿吃了2个，儿子吃了2个，老公吃了2个。夜深孩子们都睡了以后，她认为剩下2个瑞士卷该自己吃，没想到遭到了老公的批评。11月4日，事件当事博主回应称，视频是真实的，删除是因为负能量太多了，看着都压抑，不想继续传播下去。#8个瑞士卷宝妈吃几个不自私#L长江云新闻的微博视频,6,5,0,6
402,-1,5.1E+15,6243779877,财涨涨high,#瑞士卷怎么分#吃东西都是跟孩子分着吃，抢着吃，这样吃起来不是更香吗？,7,1,0,7
403,-1,5.1E+15,2665832730,邹晨辉Finan,#瑞士卷怎么分#这个应该严查，炮制流量，愚弄大家,5,0,0,5
404,-1,5.1E+15,5729441116,临汾美食君,#瑞士卷事件博主删除视频#【#瑞士卷事件博主删除视频#，#瑞士卷事件博主否认摆拍制造对立#】近日，一博主发布的“吃2个瑞士卷换来老公的一顿教育”吐槽视频，让“瑞士卷怎么分”持续引发热议。有网友顺势“拷问”起自己的甚至全天下的“老公”；也有网友怀疑是“剧本”，纯粹博取流量。目前，当事博主已删除视频，称不想继续传播负能量。但否认摆拍、搞男女对立。#别掉进8个瑞士卷怎么分的话题陷阱#,2,2,0,2
405,-1,5.1E+15,1371163915,枣庄在线,【#瑞士卷事件博主删除视频#，#瑞士卷事件博主否认摆拍制造对立#】近日，一博主发布的“吃2个瑞士卷换来老公的一顿教育”吐槽视频，让“瑞士卷怎么分”持续引发热议。有网友顺势“拷问”起自己的甚至全天下的“老公”；也有网友怀疑是“剧本”，纯粹博取流量。目前，当事博主已删除视频，称不想继续传播负能量。但否认摆拍、搞男女对立。#别掉进8个瑞士卷怎么分的话题陷阱#,2,2,0,2
406,-1,5.1E+15,1760298927,陆锡鑫,【#瑞士卷事件博主删除视频#，#瑞士卷事件博主否认摆拍制造对立#】啥破事？完全是打拳行为，制造性别对立，蛊惑不婚不育。近日，一博主发布的“吃2个瑞士卷换来老公的一顿教育”吐槽视频，让“瑞士卷怎么分”持续引发热议。有网友顺势“拷问”起自己的甚至全天下的“老公”；也有网友怀疑是“剧本”，纯粹博取流量。目前，当事博主已删除视频，称不想继续传播负能量。但否认摆拍、搞男女对立。#别掉进8个瑞士卷怎么分的话题陷阱#（本条信源@广州日报）,1,0,0,1
407,-1,5.1E+15,5370248051,柚柚山里妹,#瑞士卷怎么分#全网妻子都在问丈夫“瑞士卷”问题，妻子一句话给室友CPU干烧了#热门视频#L柚柚山里妹的微博视频,1,0,0,1
408,-1,5.1E+15,2661992301,买家张俊,#8个瑞士卷宝妈吃几个不自私#虽然我认为那个是剧本摆拍的视频，但是8个瑞士卷宝妈吃几个不自私确实是个可以探讨的问题。如果有8个瑞士卷，四口之家的话，我能想到的有以下几种答案：1、每人2个2、夫妻各1个，两个孩子各3个3、丈夫不吃，妻子吃2个，两个孩子各3个4、丈夫不吃，妻子吃1个，老大吃3个，老二吃4个5、夫妻都不吃，两个孩子各4个那对摆拍夫妻的答案，居然是妻子不能吃，丈夫吃2个，两个孩子各3个，这个答案在我这里超纲了，所以也只有这个答案拍出来才能火。#瑞士卷怎么分##瑞士卷事件博主删除视频#L买家张俊的微博视频,81,74,65,146
409,-1,5.1E+15,5992784847,笑笑说红尘,#瑞士卷怎么分#这男的怎么不上天呢，他多呼吸一口，他家娃就少一口新鲜空气，为了他娃的健康着想，他也不能和娃抢啊。有人说关键是没钱，有钱多买一盒就不会出现这样的争执了。其实瑞士卷就等同于黄圣依的账户，就是一个家庭里资源分配的问题。谁有话语权，谁有资格花钱。,1,2,0,1
410,-1,5.1E+15,1760298927,陆锡鑫,#瑞士卷事件博主删除视频#跟着感觉走，所评即所想。纯属博流量，搞性别对立。#瑞士卷事件博主否认摆拍制造对立##瑞士卷怎么分#,2,0,0,2
411,-1,5.1E+15,5992784847,笑笑说红尘,#瑞士卷怎么分#看聊天记录，求生欲都挺强的，怎么偏偏女主就被怼无语了,1,3,0,1
412,-1,5.1E+15,2435118200,Verme_咯,#瑞士卷怎么分#就不能多买一盒吗,2,0,0,2
413,-1,5.1E+15,6043311739,大兰州,#别掉进8个瑞士卷怎么分的话题陷阱#看到一个博主对瑞士卷事件的观点分享，觉得很有道理。拿瑞士卷怎么分这个问题问自己的伴侣其实没什么意义，吃多少的选择权在自己，在于自己有没有经济独立的能力。L循环信昊的微博视频,9,12,0,9
414,-1,5.1E+15,6484706301,光绪年间的银元,#瑞士卷怎么分席卷全网老公#盒马高端商战,8,8,0,8
415,-1,5.1E+15,7928477727,燕麦不加片,逆水寒手游超话#假如ai来分瑞士卷#当我问戒哥、小寒和高衙内：“假如有8个天赏石，你会怎么分？”好好好，都统一口径是吧？,0,0,0,0
416,-1,5.1E+15,2248834985,四川魏静,#瑞士卷事件博主否认摆拍制造对立#近日，一博主发布的“吃2个瑞士卷换来老公的一顿教育”吐槽视频，让“瑞士卷怎么分”持续引发热议。有网友顺势“拷问”起自己的甚至全天下的“老公”；也有网友怀疑是“剧本”，纯粹博取流量。目前，当事博主已删除视频，称不想继续传播负能量。但否认摆拍、搞男女对立。#别掉进8个瑞士卷怎么分的话题陷阱#,1,0,0,1
417,-1,5.1E+15,1371163915,枣庄在线,【#瑞士卷事件博主删除视频#，#瑞士卷事件博主否认摆拍制造对立#】近日，一博主发布的“吃2个瑞士卷换来老公的一顿教育”吐槽视频，让“瑞士卷怎么分”持续引发热议。有网友顺势“拷问”起自己的甚至全天下的“老公”；也有网友怀疑是“剧本”，纯粹博取流量。目前，当事博主已删除视频，称不想继续传播负能量。但否认摆拍、搞男女对立。#别掉进8个瑞士卷怎么分的话题陷阱#,1,3,0,1
418,-1,5.1E+15,3820836334,高队,【#瑞士卷事件博主删除视频#，#瑞士卷事件博主否认摆拍制造对立#】近日，一博主发布的“吃2个瑞士卷换来老公的一顿教育”吐槽视频，让“瑞士卷怎么分”持续引发热议。有网友顺势“拷问”起自己的甚至全天下的“老公”；也有网友怀疑是“剧本”，纯粹博取流量。目前，当事博主已删除视频，称不想继续传播负能量。但否认摆拍、搞男女对立。#别掉进8个瑞士卷怎么分的话题陷阱#,4,2,0,4
419,-1,5.1E+15,2155926845,幻想狂劉先生,#瑞士卷怎么分#我姥姥今年90岁了，她不识字，但是能把自己照顾的很好，我每次回去看她的时候，她都要给我分享她每天出去遛弯时的见闻。她最近给我讲的一个见闻：她遛弯时看到一对年轻夫妻开着货车在小区里卖保健品（这个小区住的老年人比较多），男的要以一个“赔本”的价格把东西卖给“爸爸妈妈们”，女的不愿意，两人争吵起来男的动手把女的推倒了。男的不管她，继续卖，女的就坐在地上边骂边哭。东西一会就被“爸爸妈妈们”买完了，女的还坐地上哭。我观察到我姥姥描述这个故事的时候似乎动了恻隐之心，就逗她：“那你觉得，他们这一出这是真的吗？”我姥姥想了一会，摇摇头，很认真的说：“不对，他们两口子才是一家呀”。从瑞士卷怎么分这个无聊至极的话题登上热搜来看，很多时候随便弄个蹩脚短剧就能引发大规模云共情，进而演变成赛博对立事件的关键，是共同体错认，而错认共同体这件事，其实和年龄学历也没有什么太直接的关系，有些人在理性和常识方面，还真就不如90岁的老太太。,706,57,152,858
420,-1,5.1E+15,6303232535,爱情时分_,#瑞士卷事件博主否认摆拍制造对立#近日，一博主发布的“吃2个瑞士卷换来老公的一顿教育”吐槽视频，让“瑞士卷怎么分”持续引发热议。有网友顺势“拷问”起自己的甚至全天下的“老公”；也有网友怀疑是“剧本”，纯粹博取流量。目前，当事博主已删除视频，称不想继续传播负能量。但否认摆拍、搞男女对立。,0,0,0,0
421,-1,5.1E+15,1577794853,互联网的一些事,所谓的“瑞士卷怎么分”大概率又是一个剧本炒作！头顶长摄像头的视觉，事件刚开始就拿手机开始拍摄……短视频刷多了，就很容易分辨出哪些摆拍。我最近刷到好多那种一看就是故意演出来的视频，真的让人看得又气又好笑。就像那种，扶弟魔女的帮弟弟被老公打了，或者跟婆婆闹矛盾老公还站婆婆那边，女的伤心得不行；还有老公把钱都花光了，被老婆骂了就问是不是不爱她了；更过分的是，有的男的吃软饭不干活，还动手打老婆；还有的孩子出点啥事，老公跟没事人一样。树立男女对立、婆媳纠纷、夫妻不和的基本上就是摆拍。你想知道怎么看出来这些是演的吗？其实挺简单的。1、眼睛视觉，摄像头跟长头上似的，能把对面人的表情、手势啥的都拍得清清楚楚，那八成就是摆拍的。2、镜头平视一直对着自己、孩子、老婆或者老公，保持一个画面，然后各种对话各种吵架，那也很可能是假的。3、视频有多个角度，一会儿这个角度，一会儿那个角度，剪辑得跟电影似的，还有特写镜头，那肯定是有人专门在旁边拍，后面还找专业人士剪辑了的。4、最绝的是，一个视频从头到尾，起因、经过、结果全都有，跟讲故事一样，那基本可以肯定，这就是个编好的剧本。#瑞士卷事件最新后续##瑞士卷事件博主删除视频##瑞士卷事件博主否认摆拍制造对立#,35,22,26,61
422,-1,5.1E+15,2661992301,买家张俊,#瑞士卷事件博主删除视频#这个瑞士卷事件调查不出什么结果的，最后只能不了了之。瑞士卷不像猫一杯编造的秦朗丢作业，秦朗那个说了具体学校，一查几年级几班没有秦朗这个学生就穿帮了。而瑞士卷，只要他们夫妻都说事情是真的，你怎么能证明是假的？大家都散了吧，不要再给他们制造热度涨粉了。#瑞士卷怎么分#L买家张俊的微博视频,77,69,67,144
423,-1,5.1E+15,2918230217,毛发医生张亮,#瑞士卷怎么分#近日，一博主发布的“吃2个瑞士卷换来老公的一顿教育”吐槽视频，让“瑞士卷怎么分”持续引发热议。有网友顺势“拷问”起自己的甚至全天下的“老公”；也有网友怀疑是“剧本”，纯粹博取流量。目前，当事博主已删除视频，称不想继续传播负能量。但否认摆拍、搞男女对立。#别掉进8个瑞士卷怎么分的话题陷阱#,0,0,0,0
424,-1,5.1E+15,1195306707,毛发医生钟飞,#瑞士卷怎么分#【#瑞士卷事件博主删除视频#，#瑞士卷事件博主否认摆拍制造对立#】近日，一博主发布的“吃2个瑞士卷换来老公的一顿教育”吐槽视频，让“瑞士卷怎么分”持续引发热议。有网友顺势“拷问”起自己的甚至全天下的“老公”；也有网友怀疑是“剧本”，纯粹博取流量。目前，当事博主已删除视频，称不想继续传播负能量。但否认摆拍、搞男女对立。#别掉进8个瑞士卷怎么分的话题陷阱#,0,0,0,0
425,-1,5.1E+15,7407508009,硬核洞察,【#瑞士卷事件博主删除视频#，#瑞士卷事件博主否认摆拍制造对立#】近日，一博主发布的“吃2个瑞士卷换来老公的一顿教育”吐槽视频，让“瑞士卷怎么分”持续引发热议。有网友顺势“拷问”起自己的甚至全天下的“老公”；也有网友怀疑是“剧本”，纯粹博取流量。目前，当事博主已删除视频，称不想继续传播负能量。但否认摆拍、搞男女对立。#别掉进8个瑞士卷怎么分的话题陷阱#（来源：广州日报）,0,0,0,0
426,-1,5.1E+15,1231253604,检者青锋,#瑞士卷怎么分#要不是剧本的话，倒可以讨论一下这件事。如果丈夫自己没有吃瑞士卷，只让孩子吃的话，那么可以指责妻子的这一举动，但问题是他也吃了，那么就不应该指责妻子。如果是剧本的话，那么应该谴责这种故意制造对立的行为。,11,14,0,11
427,-1,5.1E+15,7479391500,克羅迪厄斯VIII,#瑞士卷事件博主删除视频#还能這麽玩是吧？那回头我也拍一个《鎏金雷龙怎么买》，拍完绝对不删#瑞士卷怎么分#,1,1,0,1
428,-1,5.1E+15,3659055067,微浪旅行攻略咖,【#瑞士卷事件博主删除视频#，#吃2个瑞士卷是摆拍吗##瑞士卷事件博主否认摆拍制造对立#】近日，一博主发布的“吃2个瑞士卷换来老公的一顿教育”吐槽视频，让“瑞士卷怎么分”持续引发热议。有网友顺势“拷问”起自己的甚至全天下的“老公”；也有网友怀疑是“剧本”，纯粹博取流量。目前，当事博主已删除视频，称不想继续传播负能量。但否认摆拍、搞男女对立。#别掉进8个瑞士卷怎么分的话题陷阱#大家来分析一下是摆拍吗？#吃2个瑞士卷是摆拍吗#,3,3,0,3
429,-1,5.1E+15,1897985313,老蒋杂谈,网友质疑“8个瑞士卷怎么分”是剧本：挑起对立矛盾！原视频已删除博主曾发文澄清称是真实的，官方回应：将核实调查#瑞士卷#8个瑞士卷怎么分#瑞士卷事件博主删除视频#L老蒋杂谈的微博视频,0,0,0,0
430,-1,5.1E+15,5896629856,下血了下雪了,#瑞士卷怎么分别成为第二个秦朗丢作业#一博主发布的“吃2个瑞士卷换来老公的一顿教育”吐槽视频，让“瑞士卷怎么分”持续引发热议。有网友顺势“拷问”起自己的甚至全天下的“老公”；也有网友怀疑是“剧本”，纯粹博取流量。目前，当事博主已删除视频，称不想继续传播负能量。但否认摆拍、搞男女对立,1,4,0,1
431,-1,5.1E+15,6988260385,绻影浮沙,瑞士卷怎么分,4,0,0,4
432,-1,5.1E+15,3162908681,觉醒的掌柜,与其研究“八个瑞士卷”怎么分，倒不如研究怎么多赚钱买“16个一盒的瑞士卷”，把“不够吃”的问题转化为“劝人多吃”。,264,3,11,275
433,-1,5.1E+15,2621678411,钢小侠,#瑞士卷怎么分##瑞士卷事件博主删除视频#一名全职宝妈博主在社交平台上发布了一段视频，记录了她和丈夫因一盒共八个瑞士卷的食物分配问题发生争吵的过程。视频显示，女儿和儿子分别吃了两个瑞士卷，丈夫也吃了两个，剩下的两个博主打算自己吃，却被丈夫严厉训斥。这段视频迅速在网络上引发热议，许多网友纷纷发表了自己的看法L钢小侠的微博视频,646,97,67,713
434,-1,5.1E+15,2070213285,天空菌,#瑞士卷怎么分#看这些所谓的互联网上的梗会觉得很无聊，什么“秋天的第一杯奶茶”，然后就有很多女生在朋友圈晒谁给她送了第一杯奶茶，包括这次的瑞士卷，其实都是非常无聊的话题，没必要上纲上线，更没有必要成为全网老公的送命题。,28,26,11,39
435,-1,5.1E+15,5142243223,吃土少女风格纪,网上：看到一个蛋糕就要为了给♂的立人设，迫不期待造/谣是♂的送的。生活里：八个瑞士卷怎么分，全职妈妈到底配不配吃瑞士卷，是要搞成家庭连续剧的。一个蛋糕而已，即便比普通的蛋糕贵一些，但莎和她身边的朋友都买得起。看到个蛋糕就要意淫是（）或者（）送的，名为嗑糖，实为给♂的立人设，造/谣都造惯了。配得感低成这样，脂粉随便带着嗑假糖，只能说明女本位意识的提高任重而道远。首先一点，别给已经澄清过的女运动员再造谣了。,758,26,32,790
436,-1,5.1E+15,1621567465,Amy素个吃货,一个没什么用的冷知识吃rolling瑞士卷的黑金抹茶味会拉绿色的�第一次看到时候差点吓死我#瑞士卷怎么分#,16,5,0,16
437,-1,5.1E+15,1915520421,王帆Fan,#给你吃瑞士卷不能代表婚姻的胜利##瑞士卷怎么分##别掉进8个瑞士卷怎么分的话题陷阱#生育失权与权力重构，由瑞士卷引发的思考。怎么分不重要，重要的是女性如何把失去的权力拿回来，这才是关系到主体性建构的大事。最近自己的状态调整好了，视频回归L王帆Fan的微博视频,545,72,38,583
438,-1,5.1E+15,6488114629,阿森正能量,#瑞士卷怎么分#瑞士卷的正确分法！"8个瑞士卷怎么分"逗比夫妻日常最近咋的都是瑞士卷风波啊东北女地位绝对厉害！L阿森正能量的微博视频,58,18,5,63
439,-1,5.1E+15,7471174617,专宠一任,正能量超话8向日葵告诉我，只要面对着阳光努力向上，日子就会变得单纯而美好。生活最好的状态，其实就是用自己喜欢的方式，走自己选择的路，过自己想要的生活，即便是平凡的岁月、平淡的日子，也能过得活色生香，充满温暖、充满乐趣、充满快乐、充满幸福。#别掉进8个瑞士卷怎么分的话题陷阱##超温馨的大熊猫亲子时光#熊家长大了也可以把妈妈抱在怀里，给妈妈安全感～#iPanda爱胖达#大熊猫张卡超话LiPanda熊猫频道的微博视频,19,19,1,20
440,-1,5.1E+15,1655134331,资深少女龙小脸,#瑞士卷怎么分#本来完全不想参与这话题的，因为我觉得太不像话了，经济下行人再丧气也要有个限度，但下班走到平时门可罗雀的手作瑞士卷专卖店，看到顾客重新盈门，又觉得挺好，总算对他们来说是件好事。,19,0,1,20
441,-1,5.1E+15,3737746574,乡下闲人萧武,#瑞士卷怎么分#吃饭的时候聊起这个事，孩他娘说，夏天我吃梦龙你也不让我吃。我说，哪有的事？她说，你说就剩最后一个了，娃要吃你不让，你自己偷偷吃了。我说，那不就行了，我还能拦住你不让吃啊？我说一下而已，你不是还是吃了嘛。软肋马上说，我说呢那次我记得还有一个梦龙，我回家找就没有了，原来是你吃了啊！他娘说，我买的我当然要吃了。,11,1,1,12
442,-1,5.1E+15,3038801145,文秀佳,#瑞士卷怎么分##瑞士卷事件博主否认摆拍制造对立#这一“瑞士卷事件”引发的一系列反应反映了当今网络时代的特点和问题。首先，该视频能够引起广泛热议，说明家庭关系中的琐事和矛盾在网络上容易引发共鸣，大家对于公平分配、夫妻相处等问题有着较高的关注度。部分网友怀疑是剧本、博取流量，这反映出公众对于网络内容真实性的警惕和质疑。在信息爆炸的时代，确实存在一些人为了吸引眼球而编造故事，导致公众对类似事件的第一反应往往是怀疑其真实性和动机。博主删除视频并否认摆拍、搞男女对立，这可能是她在面对舆论压力和误解时的一种自我保护和澄清。她或许只是想分享生活中的一个瞬间，却没想到引发了如此大的争议。从这个事件可以看出，网络传播的力量巨大，一个小小的生活片段可能被无限放大和解读。对于博主来说，需要谨慎分享个人生活，因为一旦发布到网络上，就很难控制其传播和影响。对于公众而言，在面对这类网络事件时，应该保持理性和客观，不要轻易被情绪左右，在没有确凿证据之前，避免过度指责和恶意揣测。同时，也应该反思如何营造一个更加健康、理性和包容的网络环境，让真正有价值的信息得到传播，避免无意义的争议和对立。,36,44,0,36
443,-1,5.1E+15,1874361623,韩东言,上次瑞士卷事件舆情发酵，是22年5月。为啥瑞士卷就这么能发酵舆情呢？其实，这样视频，都是导演作品，都是摆拍，不管你信不信，不管你承认不承认，很多细节都出卖你了，比如拍摄角度。【#瑞士卷事件博主删除视频#，#瑞士卷事件博主否认摆拍制造对立#】近日，一博主发布的“吃2个瑞士卷换来老公的一顿教育”吐槽视频，让“瑞士卷怎么分”持续引发热议。有网友顺势“拷问”起自己的甚至全天下的“老公”；也有网友怀疑是“剧本”，纯粹博取流量。目前，当事博主已删除视频，称不想继续传播负能量。但否认摆拍、搞男女对立。#别掉进8个瑞士卷怎么分的话题陷阱#,56,10,1,57
444,-1,5.1E+15,2821638943,九哥爱学习,【#瑞士卷事件博主删除视频#，#瑞士卷事件博主否认摆拍制造对立#】九州微评超话近日，一博主发布的“吃2个瑞士卷换来老公的一顿教育”吐槽视频，让“瑞士卷怎么分”持续引发热议。有网友顺势“拷问”起自己的甚至全天下的“老公”；也有网友怀疑是“剧本”，纯粹博取流量。目前，当事博主已删除视频，称不想继续传播负能量。但否认摆拍、搞男女对立。#别掉进8个瑞士卷怎么分的话题陷阱#,1,0,0,1
445,-1,5.1E+15,7455088119,盖世肉姐,#网信办将核实调查瑞士卷事件#网友质疑‘8个瑞士卷怎么分‘’是剧本’挑起对立矛盾！L盖世肉姐的微博视频,2,1,0,2
446,-1,5.1E+15,3219024913,烨磊新蕾,#瑞士卷风波当事人称非摆拍#【#8个瑞士卷怎么分当事人发声#：非摆拍，当时夫妻俩正闹口角】#瑞士卷风波当事人称非摆拍#不久前，一位全职宝妈博主在社交平台上发布了一条视频，记录了她和丈夫的一次争吵。一盒瑞士卷8个，女儿吃了2个，儿子吃了2个，丈夫吃了2个，博主认为剩下2个该自己吃，没想到蛋糕还没进嘴里，却遭到了丈夫的一顿教训，理由是家长应多以身作则，多吃正餐、少吃零食，而且如果妈妈吃了，孩子就没得吃了。,2,0,0,2
447,-1,5.1E+15,3051949107,兰州微导航,【评论丨#别掉进8个瑞士卷怎么分的话题陷阱#】#瑞士卷怎么分别成为第二个秦朗丢作业#“8个瑞士卷怎么分？”近日，相关词条冲上了热搜。据报道，这个问题源自一女子在网络上发布的一则视频。视频记录了她与老公的一次争吵：家里买了一盒瑞士卷，总共8个，女儿吃了2个，儿子吃了2个，老公吃了2个。夜深孩子们都睡了以后，她拿出剩下的2个瑞士卷自己吃，还没进嘴里，就遭到了老公的一顿批评，理由是家长应多以身作则多吃正餐少吃零食，而且如果妈妈吃了，孩子就没得吃了。初看这个问题，还以为是一道数学题。仔细一看，原来是道“伦理题”。视频中女子感叹，原来自己已经卑微到连自主吃一个小蛋糕的权利都没有了。在网传的视频配文中，她提及和女儿说起想和丈夫离婚时，女儿小小的身体哭得发抖，于是她就只能妥协了。理性地说，有两种可能，一是这条视频记录的是真事。生活中，有的夫妻就是容易因为生活琐事而产生较大的争端，甚至因饭菜不合口味、因谁来做饭而吵到家庭“崩盘”的案例也有不少。当然，也有一种可能，视频内容只是一个段子。正如一些网友怀疑这多半是编的，就是为了挑起对立和矛盾来博取流量。无论事件性质如何，旁人都不妨把它当成一段网络“花絮”看待就好。正应了这句话，一旦把“花絮”当成严肃话题，不仅正襟危坐地“做题”，还陷入牛角尖，甚至影响到自己的价值判断和家庭稳定，那就属于别人挖坑自己跳了。确实，谁都有权利评判一件事，且谁也无法预料自己的一次点击会成为网络海啸的一份力量，但须知，“秦朗巴黎丢作业”的殷鉴不远，点到为止，远离“话题撕裂”，不扩大，不伤人，也是一种有意义的理性。O网页链接O评论丨别掉进“八个瑞士卷怎么分”的话题陷阱,1,7,0,1
448,-1,5.1E+15,3146463564,圈内漂流瓶,搞笑体育｜搞笑配音｜莎头组合｜孙颖莎问王楚钦八个瑞士卷怎么分？L圈内漂流瓶的微博视频,38,1,0,38
449,-1,5.1E+15,5729441116,临汾美食君,#瑞士卷风波当事人称非摆拍#【#8个瑞士卷怎么分当事人发声#：非摆拍，当时夫妻俩正闹口角】#瑞士卷风波当事人称非摆拍#不久前，一位全职宝妈博主在社交平台上发布了一条视频，记录了她和丈夫的一次争吵。一盒瑞士卷8个，女儿吃了2个，儿子吃了2个，丈夫吃了2个，博主认为剩下2个该自己吃，没想到蛋糕还没进嘴里，却遭到了丈夫的一顿教训，理由是家长应多以身作则，多吃正餐、少吃零食，而且如果妈妈吃了，孩子就没得吃了。该条视频引起了网络热议，有网友和媒体怀疑视频是一个剧本。对此，博主在11月3日发文称，她和丈夫最近矛盾确实有点多，视频是真实的，因不想继续传播负能量，所以就删除了。11月5日，记者辗转与该事件当事人取得了联系，并与社区工作人员一同与她见了面。记者了解到，博主确为一名全职宝妈，目前与丈夫租房子生活，视频并非摆拍。视频拍摄于10月28日晚八点多，两个孩子刚刚入睡，她便打算将剩下的两个瑞士卷吃了。“那天我丈夫跟了很久的一个外贸订单黄了，情绪也不是很好，才说了视频中那些话。”当事人表示，近期双方生活、工作压力都比较大，时有争吵，当天本想在吃瑞士卷时拍个视频记录生活，“没想到丈夫会说那些。”该当事人表示，视频是她对话发生后第二天晚上发布的，此后夫妻俩都仍在正常生活，“这段时间两个人情绪都不太好，本来只是想发发牢骚，后来没想到会发酵那么厉害，就立马删除了。”“这次事件占用了太多公共资源，给大家带来不必要的困扰，我也感到非常后悔和抱歉。”当事人说。当天，社区工作人员也对该当事人的生活状况进行了进一步了解，并分享相关的公益性、普惠性服务，为当事人家庭疏解压力提供帮助。（潮新闻）#瑞士卷风波当事人道歉#,0,0,0,0
450,-1,5.1E+15,5729441116,临汾美食君,#当地居委会回应瑞士卷风波#【#当地居委会回应瑞士卷风波#】#瑞士卷风波当事人称非摆拍#近日，女子发视频自我曝光就8个瑞士卷怎么分享一事与丈夫进行争论，事情发酵后引发网友热议，也有网友质疑此事是剧本。新黄河记者了解到，当事人居住地在浙江省义乌市。11月5日晚，新黄河记者从义乌市相关社区负责人及知情人处了解到，社区已经去当事人家里了解过情况，但当事人有点抵触，社区正准备第二次去入户调查。11月5日，新黄河记者联系女博主未能成功，但了解到女博主的住址是在浙江省义乌市。11月5日，有媒体记者辗转与该事件当事人取得了联系，并与社区工作人员一同与她见了面。记者了解到，博主确为一名全职宝妈，目前与丈夫租房子生活，视频并非摆拍。视频拍摄于10月28日晚八点多，两个孩子刚刚入睡，她便打算将剩下的两个瑞士卷吃了。“那天我丈夫跟了很久的一个外贸订单黄了，情绪也不是很好，才说了视频中那些话。”当事人表示，近期双方生活、工作压力都比较大，时有争吵，当天本想在吃瑞士卷时拍个视频记录生活，“没想到丈夫会说那些。”该当事人表示，视频是她对话发生后第二天晚上发布的，此后夫妻俩都仍在正常生活，“这段时间两个人情绪都不太好，本来只是想发发牢骚，后来没想到会发酵那么厉害，就立马删除了。”“这次事件占用了太多公共资源，给大家带来不必要的困扰，我也感到非常后悔和抱歉。”当事人说。@新黄河·济南时报#8个瑞士卷怎么分当事人发声#L新黄河·济南时报的微博视频,1,1,0,1
451,-1,5.1E+15,7805609625,杭田视频,【#瑞士卷怎么分席卷全网老公#】这两天，“瑞士卷怎么分”应该已经成为每一位老公的必考题了。#8个瑞士卷宝妈吃几个不自私#事情的起因得追溯到一条相当气人的视频，10月28日，一位全职宝妈在社交平台上发布了一条视频。视频的内容记录了她与老公的一次争吵，争吵的原因简单到你难以想象宝妈当天买了一盒瑞士卷，总共8个瑞士卷，女儿吃了2个，儿子吃了2个，老公吃了2个。夜深孩子们都睡了以后，她自然认为剩下2个瑞士卷该自己吃，没想到蛋糕还没进嘴里，却遭到了老公的一顿批评。至于为什么不让吃，她老公给出的理由是：①他认为瑞士卷是零食，自己老婆应该吃饭的时候多吃饭，这样才算给孩子们当榜样，而不是晚上吃零食。②他认为，瑞士卷他老婆吃了，孩子就没得吃了，所以吃瑞士卷是自私的行为。一顿话下来把老婆都气无语了。当初是你让我当全职妈妈的，现在却吃个蛋糕都要管东管西。结果，老公根本没想着去听宝妈的话，反手就是否认三连，把一句“你又想多了”扣在宝妈头上。在网友们愤愤不平的同时，“我可以吃几个瑞士卷”也成为了全网老公们的必考题。（脊梁in上海SH）,4,6,0,4
452,-1,5.1E+15,1859661774,金华磊哥,#瑞士卷#对话“8个瑞士卷怎么分”当事人独家回应：非摆拍，当时夫妻俩正闹口角不久前，一位全职宝妈博主在社交平台上发布了一条视频，记录了她和丈夫的一次争吵。一盒瑞士卷8个，女儿吃了2个，儿子吃了2个，丈夫吃了2个，博主认为剩下2个该自己吃，没想到蛋糕还没进嘴里，却遭到了丈夫的一顿教训，理由是家长应多以身作则，多吃正餐、少吃零食，而且如果妈妈吃了，孩子就没得吃了。该条视频引起了网络热议，有网友和媒体怀疑视频是一个剧本。对此，博主在11月3日发文称，她和丈夫最近矛盾确实有点多，视频是真实的，因不想继续传播负能量，所以就删除了。11月5日，潮新闻记者辗转与该事件当事人取得了联系，并与社区工作人员一同与她见了面。记者了解到，博主确为一名全职宝妈，平时喜欢用短视频记录生活，目前与丈夫租房子生活，视频并非摆拍。视频拍摄于10月28日晚八点多，两个孩子刚刚入睡，她便打算将剩下的两个瑞士卷吃了。“那天我丈夫跟了很久的一个外贸订单黄了，情绪也不是很好，才说了视频中那些话。”当事人表示，近期双方生活、工作压力都比较大，时有争吵，当天本想在吃瑞士卷时拍个视频记录生活，“没想到丈夫会说那些。”该当事人表示，视频是她对话发生后第二天晚上发布的，此后夫妻俩都仍在正常生活，“这段时间两个人情绪都不太好，本来只是想发发牢骚，后来没想到会发酵那么厉害，就立马删除了。”“这次事件占用了太多公共资源，给大家带来不必要的困扰，我也感到非常后悔和抱歉。”当事人说。当天，社区工作人员也对该当事人的生活状况进行了进一步了解，并分享相关的公益性、普惠性服务，为当事人家庭疏解压力提供帮助。#当地居委会回应瑞士卷风波#,1,1,0,1
453,-1,5.1E+15,3051949107,兰州微导航,【#瑞士卷事件博主删除视频#，#瑞士卷事件博主否认摆拍制造对立#】近日，一博主发布的“吃2个瑞士卷换来老公的一顿教育”吐槽视频，让“瑞士卷怎么分”持续引发热议。有网友顺势“拷问”起自己的甚至全天下的“老公”；也有网友怀疑是“剧本”，纯粹博取流量。目前，当事博主已删除视频，称不想继续传播负能量。但否认摆拍、搞男女对立。#别掉进8个瑞士卷怎么分的话题陷阱#,1,5,0,1
454,-1,5.1E+15,5649170494,兰州微播,【评论丨#别掉进8个瑞士卷怎么分的话题陷阱#】#瑞士卷怎么分别成为第二个秦朗丢作业#“8个瑞士卷怎么分？”近日，相关词条冲上了热搜。据报道，这个问题源自一女子在网络上发布的一则视频。视频记录了她与老公的一次争吵：家里买了一盒瑞士卷，总共8个，女儿吃了2个，儿子吃了2个，老公吃了2个。夜深孩子们都睡了以后，她拿出剩下的2个瑞士卷自己吃，还没进嘴里，就遭到了老公的一顿批评，理由是家长应多以身作则多吃正餐少吃零食，而且如果妈妈吃了，孩子就没得吃了。初看这个问题，还以为是一道数学题。仔细一看，原来是道“伦理题”。视频中女子感叹，原来自己已经卑微到连自主吃一个小蛋糕的权利都没有了。在网传的视频配文中，她提及和女儿说起想和丈夫离婚时，女儿小小的身体哭得发抖，于是她就只能妥协了。理性地说，有两种可能，一是这条视频记录的是真事。生活中，有的夫妻就是容易因为生活琐事而产生较大的争端，甚至因饭菜不合口味、因谁来做饭而吵到家庭“崩盘”的案例也有不少。当然，也有一种可能，视频内容只是一个段子。正如一些网友怀疑这多半是编的，就是为了挑起对立和矛盾来博取流量。无论事件性质如何，旁人都不妨把它当成一段网络“花絮”看待就好。正应了这句话，一旦把“花絮”当成严肃话题，不仅正襟危坐地“做题”，还陷入牛角尖，甚至影响到自己的价值判断和家庭稳定，那就属于别人挖坑自己跳了。确实，谁都有权利评判一件事，且谁也无法预料自己的一次点击会成为网络海啸的一份力量，但须知，“秦朗巴黎丢作业”的殷鉴不远，点到为止，远离“话题撕裂”，不扩大，不伤人，也是一种有意义的理性。O网页链接O评论丨别掉进“八个瑞士卷怎么分”的话题陷阱,2,5,0,2
455,-1,5.1E+15,6509274343,顺意姝秦好运暴富,#瑞士卷怎么分#用吃榴莲、草莓尖尖、买化妆品或瑞士卷等行为来测试伴侣是否爱自己，这种方式是不恰当且不合理的。感情是复杂的，不能用单一的行为或物质消费来衡量。真正的爱是建立在相互理解、尊重、信任和长期的相处基础上，这样的测试不仅无法准确反映出伴侣的真实感情，反而可能会对双方的关系造成伤害，破坏原本的信任。比如之前网上有人分享伴侣没有给自己买草莓尖尖就觉得对方不爱自己，这种片面的判断标准可能会引发不必要的矛盾和争吵。对于这类现象，我们应该保持理性的态度，认识到感情的复杂性和多样性，不要轻易被网络上的一些观点和行为所影响。同时，我们也应该倡导健康、积极的价值观和行为方式，共同营造一个和谐、美好的社会环境。,8,1,0,8
456,-1,5.1E+15,2003059572,防务的避风港,看短视频平台，好多女的拍视频问老公怎么分瑞士卷……有病看病好吧？,302,36,2,304
457,-1,5.1E+15,2661992301,买家张俊,#别掉进8个瑞士卷怎么分的话题陷阱#完了，已经掉进这个陷阱了…我老婆已经也说一看就是摆拍，但是她也问我，如果我家里有8个瑞士卷，她能吃吗？能吃几个？我们一家三口人如何分配？我是这么回答的：我不喜欢吃蛋糕，你跟儿子每人4个。结果她说：你是不喜欢吃才让我们吃的吧？要是你喜欢吃的东西呢？我…我恨这对瑞士卷摆拍夫妻！#瑞士卷怎么分#L买家张俊的微博视频,99,77,78,177
458,-1,5.1E+15,5649170494,兰州微播,【#瑞士卷事件博主删除视频#，#瑞士卷事件博主否认摆拍制造对立#】近日，一博主发布的“吃2个瑞士卷换来老公的一顿教育”吐槽视频，让“瑞士卷怎么分”持续引发热议。有网友顺势“拷问”起自己的甚至全天下的“老公”；也有网友怀疑是“剧本”，纯粹博取流量。目前，当事博主已删除视频，称不想继续传播负能量。但否认摆拍、搞男女对立。#别掉进8个瑞士卷怎么分的话题陷阱#,2,7,0,2
459,-1,5.1E+15,1764406347,智趣威虎山,看完龙江美景，绝对可以分好瑞士卷~#瑞士卷怎么分#黑龙江美好推荐官，用N种方式打开黑龙江#冰雪燃盛世激情迎亚冬##我与亚冬同框#带着微博去旅行超话L畅赏黑龙江（黑龙江文旅）的快手视频,3,2,0,3
460,-1,5.1E+15,6467575955,嘻嘻哈哈哭哭咧咧,#瑞士卷怎么分#超市9.9一盒8个，至于的吗？还分。我很少买，因为吃不完容易坏，除非单位买一盒同事们分一分。女士义愤填膺，男士受到测试两口子为了一口吃的吵架或者演段子。,16,15,0,16
461,-1,5.1E+15,5942078088,王铁锤爱吃瓜,#瑞士卷怎么分#关于瑞士卷的问题沸沸扬扬讨论好几天，确实感觉有点剧本的成分，不过也有律师说明如果摆拍会有被追究的风险，可如果是真实的，那么我提这对夫妻可悲，妈妈的付出没有得到认可，妈妈自我也在否定自己，爸爸趾高气昂没受过社会毒打，老一套思想处理夫妻关系，换一句话说，吃点好的吧,4,2,0,4
462,-1,5.1E+15,7805609625,杭田视频,#瑞士卷怎么分的起因#【瑞士卷怎么分席卷全网老公】#瑞士卷怎么分成老公必考题#据新闻晨报这两天，“瑞士卷怎么分”应该已经成为每一位老公的必考题了。事情的起因得追溯到一条相当气人的视频，10月28日，一位全职宝妈在社交平台上发布了一条视频。视频的内容记录了她与老公的一次争吵，争吵的原因简单到你难以想象。宝妈当天买了一盒瑞士卷，总共8个瑞士卷，女儿吃了2个，儿子吃了2个，老公吃了2个。夜深孩子们都睡了以后，她自然认为剩下2个瑞士卷该自己吃，没想到蛋糕还没进嘴里，却遭到了老公的一顿批评。至于为什么不让吃，她老公给出的理由是：①他认为瑞士卷是零食，自己老婆应该吃饭的时候多吃饭，这样才算给孩子们当榜样，而不是晚上吃零食。②他认为，瑞士卷他老婆吃了，孩子就没得吃了，所以吃瑞士卷是自私的行为。一顿话下来把老婆都气无语了。当初是你让我当全职妈妈的，现在却吃个蛋糕都要管东管西。结果，老公根本没想着去听宝妈的话，反手就是否认三连，把一句“你又想多了”扣在宝妈头上。在网友们愤愤不平的同时，“我可以吃几个瑞士卷”也成为了全网老公们的必考题。瑞士卷怎么分（脊梁in上海SH）,1,3,0,1
463,-1,5.1E+15,3237614823,千万正能量,#瑞士卷怎么分#瑞士卷事件从一开始就透着剧本味儿。博主删除视频，更像是此地无银三百两。如今网络真假难辨，这种看似博眼球的内容充斥其中。他们利用大众的同情心或正义感来赚取流量，实在可恶。希望网友们能擦亮眼睛，别轻易被虚假信息左右，也希望网络环境能少些这种套路满满的剧本，多些真实有价值的分享。,1,1,1,2
464,-1,5.1E+15,6043311739,大兰州,【评论丨#别掉进8个瑞士卷怎么分的话题陷阱#】#瑞士卷怎么分别成为第二个秦朗丢作业#“8个瑞士卷怎么分？”近日，相关词条冲上了热搜。据报道，这个问题源自一女子在网络上发布的一则视频。视频记录了她与老公的一次争吵：家里买了一盒瑞士卷，总共8个，女儿吃了2个，儿子吃了2个，老公吃了2个。夜深孩子们都睡了以后，她拿出剩下的2个瑞士卷自己吃，还没进嘴里，就遭到了老公的一顿批评，理由是家长应多以身作则多吃正餐少吃零食，而且如果妈妈吃了，孩子就没得吃了。初看这个问题，还以为是一道数学题。仔细一看，原来是道“伦理题”。视频中女子感叹，原来自己已经卑微到连自主吃一个小蛋糕的权利都没有了。在网传的视频配文中，她提及和女儿说起想和丈夫离婚时，女儿小小的身体哭得发抖，于是她就只能妥协了。理性地说，有两种可能，一是这条视频记录的是真事。生活中，有的夫妻就是容易因为生活琐事而产生较大的争端，甚至因饭菜不合口味、因谁来做饭而吵到家庭“崩盘”的案例也有不少。当然，也有一种可能，视频内容只是一个段子。正如一些网友怀疑这多半是编的，就是为了挑起对立和矛盾来博取流量。无论事件性质如何，旁人都不妨把它当成一段网络“花絮”看待就好。正应了这句话，一旦把“花絮”当成严肃话题，不仅正襟危坐地“做题”，还陷入牛角尖，甚至影响到自己的价值判断和家庭稳定，那就属于别人挖坑自己跳了。确实，谁都有权利评判一件事，且谁也无法预料自己的一次点击会成为网络海啸的一份力量，但须知，“秦朗巴黎丢作业”的殷鉴不远，点到为止，远离“话题撕裂”，不扩大，不伤人，也是一种有意义的理性。O评论丨别掉进“八个瑞士卷怎么分”的话题陷阱,6,13,0,6
465,-1,5.1E+15,1516170715,不止是飞行,#瑞士卷当事人称非常后悔并抱歉#据潮新闻11月5日报道，“8个瑞士卷怎么分”事件的当事人称，视频并非摆拍，当事人是一名全职宝妈，目前与丈夫租房子生活。到底是不是摆拍，只有当事人自己的最为清楚。这件事最可怕的地方在于，原本一件小事情却被无限放大，从个例直接跨越到群体，一群人在拱火，这与之前自己工资买榴莲被老公责怪的一个套路。视频拍摄于10月28日晚八点多，当时两个孩子刚刚入睡，她打算吃剩下的两个瑞士卷。而那天她丈夫跟了很久的一个外贸订单黄了，情绪不佳，才说了视频中那些话。当事人表示近期双方生活、工作压力都比较大，时有争吵，当天本想拍个视频记录生活，没想到丈夫会那样说。该视频于对话发生后的第二天晚上发布，之后夫妻俩仍正常生活。但由于这段时间两人情绪都不好，本只是想发发牢骚，没想到事情会发酵得如此厉害，便立马删除了视频。当事人还说：“这次事件占用了太多公共资源，给大家带来不必要的困扰，我也感到非常后悔和抱歉。”当天，社区工作人员也对当事人的生活状况进行了进一步了解，并分享了相关的公益性、普惠性服务，为其家庭疏解压力提供帮助。律师发声针对此事，有律师表示：根据有关规定，在自媒体发布虚构情节，剧情等内容应当按照有关要求，其以显著方式标记虚构或演绎标签；摆拍、虚假编造、误导群众，挑起公众情绪对立，扰乱社会秩序，造成社会不良影响，将依法追究法律责任。结语本身孙菲菲就是带货主播，现在经常和老公一起直播，甚至有网友发现，孙菲菲已经在直播间卖瑞士卷了。如果这件事情真的是虚构的，是剧情，那“瑞士卷”事件女主孙菲菲很可能会受严厉的处罚。另一方面，一次次的出现靠制造男女对立、冲突、矛盾的网红事件，也说明了网络监管这方面真的需要加强，有关的惩处更应该严厉。期待，后续看到官方的调查通报，给我们揭开事情的真相！,50,8,0,50
466,-1,5.1E+15,5480412715,兰州微事,【评论丨#别掉进8个瑞士卷怎么分的话题陷阱#】#瑞士卷怎么分别成为第二个秦朗丢作业#“8个瑞士卷怎么分？”近日，相关词条冲上了热搜。据报道，这个问题源自一女子在网络上发布的一则视频。视频记录了她与老公的一次争吵：家里买了一盒瑞士卷，总共8个，女儿吃了2个，儿子吃了2个，老公吃了2个。夜深孩子们都睡了以后，她拿出剩下的2个瑞士卷自己吃，还没进嘴里，就遭到了老公的一顿批评，理由是家长应多以身作则多吃正餐少吃零食，而且如果妈妈吃了，孩子就没得吃了。初看这个问题，还以为是一道数学题。仔细一看，原来是道“伦理题”。视频中女子感叹，原来自己已经卑微到连自主吃一个小蛋糕的权利都没有了。在网传的视频配文中，她提及和女儿说起想和丈夫离婚时，女儿小小的身体哭得发抖，于是她就只能妥协了。理性地说，有两种可能，一是这条视频记录的是真事。生活中，有的夫妻就是容易因为生活琐事而产生较大的争端，甚至因饭菜不合口味、因谁来做饭而吵到家庭“崩盘”的案例也有不少。当然，也有一种可能，视频内容只是一个段子。正如一些网友怀疑这多半是编的，就是为了挑起对立和矛盾来博取流量。无论事件性质如何，旁人都不妨把它当成一段网络“花絮”看待就好。正应了这句话，一旦把“花絮”当成严肃话题，不仅正襟危坐地“做题”，还陷入牛角尖，甚至影响到自己的价值判断和家庭稳定，那就属于别人挖坑自己跳了。确实，谁都有权利评判一件事，且谁也无法预料自己的一次点击会成为网络海啸的一份力量，但须知，“秦朗巴黎丢作业”的殷鉴不远，点到为止，远离“话题撕裂”，不扩大，不伤人，也是一种有意义的理性。O网页链接O评论丨别掉进“八个瑞士卷怎么分”的话题陷阱,1,3,0,1
467,-1,5.1E+15,7307104795,八爷煮娱,#瑞士卷怎么分席卷全网老公#老婆孩子先吃，不够吃再买！我不吃甜的,3,5,0,3
468,-1,5.1E+15,2799368122,总裁视野,#别掉进8个瑞士卷怎么分的话题陷阱#一博主发布的“吃2个瑞士卷换来老公的一顿教育”吐槽视频，让“瑞士卷怎么分”持续引发热议。有网友顺势“拷问”起自己的甚至全天下的“老公”；也有网友怀疑是“剧本”，纯粹博取流量。目前，当事博主已删除视频，称不想继续传播负能量。但否认摆拍、搞男女对立L总裁视野的微博视频,2,2,2,4
469,-1,5.1E+15,7351931353,银行员日记,#瑞士卷怎么分席卷全网老公#草，好弱智，好有趣。8个瑞士卷，整盒买不单卖，怎么分?她们俩控制体重一人吃半个，我吃剩下的7个。看来经济下行还是有空间的，这不还是吃挺饱吗?,32,8,0,32
470,-1,5.1E+15,1974369921,西山派苏易水尚食-九尾草YD,#瑞士卷怎么分#怎么瑞士卷的故事还没结束啊,0,0,0,0
471,-1,5.1E+15,3830188552,王珅葳,#马天宇建议取消8个装瑞士卷#最近感觉瑞士卷超级火，走到哪里都是瑞士卷排队，真不知道是一时兴起，还是真有多好吃。这玩意难道不是减肥者的敌人吗？#瑞士卷怎么分#,2,1,0,2
472,-1,5.1E+15,7823043990,追光者-九神,#马天宇建议取消8个装瑞士卷#8G冲浪达人马天宇来分析“8个瑞士卷怎么分”；一个男人的犯的错，全天下男人得考试，我建议取消8个装瑞士卷～,0,0,0,0
473,-1,5.1E+15,7839325536,AA默默8665,#8个瑞士卷怎么分当事人发声#有什么好道歉的，这不是很多家庭婚姻的正常现象吗，谁家生活还不是一地鸡毛，放大出来能过下去有几家，生活不易，且行且珍惜,20,8,0,20
474,-1,5.1E+15,7823145697,半谷羽-,#瑞士卷当事人称非常后悔并抱歉#这俩就应该�，剩俩个瑞士卷都不给你吃还不赶快离婚还有发网上来气网友，评论区里问男朋友怎么分的也感觉世界像是一个巨大的娇妻文学,60,0,0,60
475,-1,5.1E+15,1850033717,ButterflyandStrawberry,赶时髦说的话，我对哥哥目前的宠溺程度是：我买瑞士卷问哥哥怎么分，哥哥应该回答我不喜欢吃甜的…你为什么只买瑞士卷�都怪我———,107,2,0,107
476,-1,5.1E+15,1251562775,新疆马南,新疆马南超话#瑞士卷怎么分##瑞士卷消费降级#大家心里都有一个观念就是想去知名度高、味道不错的烘焙馆，而那些私人创业开的小烘焙馆就很少有人去买，不能说店小品质就不好，我们选择的瑞士卷也一样，按个人口味，你觉得好吃它在哪个店占重要的位置。,1,1,0,1
477,-1,5.1E+15,6824843155,I毅世-淇缘,孙颖莎问王楚钦8个瑞士卷怎么分？莎头LI毅世-淇缘的微博视频,26,0,0,26
478,-1,5.1E+15,1442690563,编剧祝明,#实况过家家#太可笑了，小杨刚刚：老婆，我吃蛋糕你吃吗？我：我不吃。我又不爱吃甜食。小杨：回答错误！你不爱我，我买的蛋糕你居然不跟我一起吃！？我：……你这剧本不太行，俗套！过了一会，小杨吃了一多半，又开始废话了小杨：这巧克力蛋糕也太甜了……还8个瑞士卷怎么分，我们家一个巧克力蛋糕都没人要分……哎……,104,23,1,105
479,-1,5.1E+15,7552240241,原味圣代_VK,#马天宇建议取消8个装瑞士卷#8G冲浪达人马天宇来分析“8个瑞士卷怎么分”；一个男人的犯的错，全天下男人得考试，我建议取消8个装瑞士卷～,1,4,0,1
480,-1,5.1E+15,5480412715,兰州微事,【#瑞士卷事件博主删除视频#，#瑞士卷事件博主否认摆拍制造对立#】近日，一博主发布的“吃2个瑞士卷换来老公的一顿教育”吐槽视频，让“瑞士卷怎么分”持续引发热议。有网友顺势“拷问”起自己的甚至全天下的“老公”；也有网友怀疑是“剧本”，纯粹博取流量。目前，当事博主已删除视频，称不想继续传播负能量。但否认摆拍、搞男女对立。#别掉进8个瑞士卷怎么分的话题陷阱#,3,2,0,3
481,-1,5.1E+15,1681192240,涅小水,#瑞士卷当事人称非常后悔并抱歉##瑞士卷怎么分#不承认是自己编的，因为会封号,35,19,14,49
482,-1,5.1E+15,5448275281,半只狐貍,#瑞士卷怎么分#典型的摆拍，她不是觉得自己错了，只是看闹大了，害怕了。。。L九派新闻的微博视频,12,1,1,13
483,-1,5.1E+15,5985166710,嗨兰州,【评论丨#别掉进8个瑞士卷怎么分的话题陷阱#】#瑞士卷怎么分别成为第二个秦朗丢作业#“8个瑞士卷怎么分？”近日，相关词条冲上了热搜。据报道，这个问题源自一女子在网络上发布的一则视频。视频记录了她与老公的一次争吵：家里买了一盒瑞士卷，总共8个，女儿吃了2个，儿子吃了2个，老公吃了2个。夜深孩子们都睡了以后，她拿出剩下的2个瑞士卷自己吃，还没进嘴里，就遭到了老公的一顿批评，理由是家长应多以身作则多吃正餐少吃零食，而且如果妈妈吃了，孩子就没得吃了。初看这个问题，还以为是一道数学题。仔细一看，原来是道“伦理题”。视频中女子感叹，原来自己已经卑微到连自主吃一个小蛋糕的权利都没有了。在网传的视频配文中，她提及和女儿说起想和丈夫离婚时，女儿小小的身体哭得发抖，于是她就只能妥协了。理性地说，有两种可能，一是这条视频记录的是真事。生活中，有的夫妻就是容易因为生活琐事而产生较大的争端，甚至因饭菜不合口味、因谁来做饭而吵到家庭“崩盘”的案例也有不少。当然，也有一种可能，视频内容只是一个段子。正如一些网友怀疑这多半是编的，就是为了挑起对立和矛盾来博取流量。无论事件性质如何，旁人都不妨把它当成一段网络“花絮”看待就好。正应了这句话，一旦把“花絮”当成严肃话题，不仅正襟危坐地“做题”，还陷入牛角尖，甚至影响到自己的价值判断和家庭稳定，那就属于别人挖坑自己跳了。确实，谁都有权利评判一件事，且谁也无法预料自己的一次点击会成为网络海啸的一份力量，但须知，“秦朗巴黎丢作业”的殷鉴不远，点到为止，远离“话题撕裂”，不扩大，不伤人，也是一种有意义的理性。O网页链接O评论丨别掉进“八个瑞士卷怎么分”的话题陷阱,0,2,0,0
484,-1,5.1E+15,6850747752,金菲璇,#马天宇建议取消8个装瑞士卷#哈哈哈，我朋友今天还跟我说、她问她老公怎么分，他老公说“缺你吃了缺你喝了，过来问我这，你想吃几个吃几个，不够了买”,1,0,0,1
485,-1,5.1E+15,5951913760,三湘头条,#马天宇建议取消8个装瑞士卷#【“8个瑞士卷怎么分”被质疑是剧本，官方以及当事人回应】#瑞士卷当事人称非常后悔并抱歉#近日，女子发视频自我曝光就8个瑞士卷怎么分享一事与丈夫进行争论，事情发酵后引发网友热议，也有网友质疑此事是剧本。新黄河记者了解到，当事人居住地在浙江省义乌市。11月5日晚，新黄河记者从义乌市相关社区负责人及知情人处了解到，社区已经去当事人家里了解过情况，但当事人有点抵触，社区正准备第二次去入户调查。据媒体此前报道，这个问题源自一女子在网络上发布的一则视频。视频记录了她与老公的一次争吵：家里买了一盒瑞士卷，总共8个，女儿吃了2个，儿子吃了2个，老公吃了2个。夜深孩子们都睡了以后，她拿出剩下的2个瑞士卷自己吃，还没进嘴里，就遭到了老公的一顿批评，理由是家长应多以身作则多吃正餐少吃零食，而且如果妈妈吃了，孩子就没得吃了。视频发布后，引发网络热议。网友们观点分成几派，有支持女博主的，也有支持她丈夫的。还有网友怀疑视频是一个剧本，质疑女博主是为了挑起对立和矛盾博取流量，多半是编的。对此，博主在11月3日发文称，她和丈夫最近矛盾确实有点多，视频是真实的，因不想继续传播负能量，所以就删除了。11月5日，潮新闻记者辗转与该事件当事人取得了联系，并与社区工作人员一同与她见了面。记者了解到，博主确为一名全职宝妈，目前与丈夫租房子生活，视频并非摆拍。视频拍摄于10月28日晚八点多，两个孩子刚刚入睡，她便打算将剩下的两个瑞士卷吃了。该当事人表示，视频是她对话发生后第二天晚上发布的，此后夫妻俩都仍在正常生活，“这段时间两个人情绪都不太好，本来只是想发发牢骚，后来没想到会发酵那么厉害，就立马删除了。”“这次事件占用了太多公共资源，给大家带来不必要的困扰，我也感到非常后悔和抱歉。”当事人说。来源：@潇湘晨报L潇湘晨报的微博视频,110,5,10,120
486,-1,5.1E+15,2661992301,买家张俊,#瑞士卷当事人称非常后悔并抱歉#我就说了吧，这件事调查不出什么结果，只要他们夫妻双方都说是真事，就只能是真的。那就当是真的来评论一下吧，一般这样夫妻不合，双方都有问题。我身边就有这样的例子，丈夫不顾妻子和孩子，妻子什么事都发朋友圈抱怨。也不知道是丈夫先不顾妻子和孩子，妻子后来喜欢抱怨的，还是妻子先喜欢抱怨，丈夫再慢慢不顾妻子和孩子的。就跟这个瑞士卷的妻子一样，她把视频发到网上，现在全网人都骂她老公自私，以后他们还能一起生活吗？#瑞士卷怎么分#L买家张俊的微博视频,77,63,70,147
487,-1,5.1E+15,6288870414,DJ八花的公主_鲸落,#马天宇建议取消8个装瑞士卷#马天宇真相了哈哈哈，天下男人下次碰到瑞士卷都要咯噔一下，到底怎么分,32,0,0,32
488,-1,5.1E+15,7764714680,kiku-荆海棠缘白,#马天宇建议取消8个装瑞士卷#8G冲浪达人马天宇来分析“8个瑞士卷怎么分”；一个男人的犯的错，全天下男人得考试，我建议取消8个装瑞士卷～,0,1,0,0
489,-1,5.1E+15,7805609625,杭田视频,【#瑞士卷事件博主删除视频##瑞士卷事件博主否认摆拍制造对立#】近日，一博主发布的“吃2个瑞士卷换来老公的一顿教育”吐槽视频，让“瑞士卷怎么分”持续引发热议。有网友顺势“拷问”起自己的甚至全天下的“老公”；也有网友怀疑是“剧本”，纯粹博取流量。目前，当事博主已删除视频，称不想继续传播负能量。但否认摆拍、搞男女对立。#别掉进8个瑞士卷怎么分的话题陷阱#,2,3,0,2
490,-1,5.1E+15,1849152565,叶建勛,#当地居委会回应瑞士卷风波#关于“8个瑞士卷怎么分”的视频事件，当事人已在多个场合发声，以下是她的主要声明：真实性声明：当事人确认视频中的事件是真实的，并非摆拍。她表示，视频记录了她和丈夫的真实争吵，因为最近家庭矛盾较多，所以决定记录下来。背景说明：视频拍摄于2024年10月28日晚上，当时孩子们已经入睡，她打算吃掉剩下的两个瑞士卷。然而，这一行为遭到了丈夫的批评，他认为作为家长应该以身作则，多吃正餐少吃零食，并且要考虑孩子的饮食需求。情感表达：当事人表示，当天丈夫因为一个外贸订单失败，情绪不佳，因此说了视频中的那些话。她承认，这段视频反映了夫妻间的生活压力和矛盾，而这些矛盾源于双方工作和生活压力较大。反思与道歉：对于此次事件占用的公共资源，当事人感到非常后悔和抱歉。她表示，视频发布后，夫妻俩的生活受到了很大影响，她意识到不应该通过这种方式发泄情绪。社区介入：义乌市相关部门和社区工作人员已对事件进行了调查，并提供了相应的帮助和支持。社区工作人员表示，他们将进一步了解当事人的生活状况，并提供必要的服务。#瑞士卷风波当事人称非摆拍#当事人强调视频的真实性，并对事件造成的社会影响表示歉意。同时，她也希望通过这次经历，提醒大家关注家庭关系和心理健康的重要性。中国超话@新黄河·济南时报#8个瑞士卷怎么分当事人发声#L叶建勛的微博视频,2,0,0,2
491,-1,5.1E+15,7518284865,小夏撞小小黄,#马天宇建议取消8个装瑞士卷#8G冲浪达人马天宇来分析“8个瑞士卷怎么分”；一个男人的犯的错，全天下男人得考试，我建议取消8个装瑞士卷～#小熊的专属ss#,0,0,0,0
492,-1,5.1E+15,1766266385,严娜妍,“瑞士卷怎么分”席卷全网老公，你被问瑞士卷问题了么？你是怎么回答的？#马天宇建议取消8个装瑞士卷##瑞士卷怎么分#L严娜妍的微博视频,7,0,0,7
493,-1,5.1E+15,3960991746,娱三少,#瑞士卷博主称当时与丈夫闹矛盾#瑞士卷其实没啥可讨论的！喜欢怎么分就怎么分！,0,0,0,0
494,-1,5.1E+15,2400966427,冬亚,#瑞士卷当事人称非常后悔并抱歉#当事人说，自己是全职宝妈，平时只是用短视频记录生活。。。。看她的账号，之前有一些带货的内容。恩。。。。。这真挺常见就这几天，那个自小意外毁容，被人说成是骗彩礼后被男方毁容的姑娘她真的较真了，要走法律途径了。其中有个博主给她回了私信，说自己是家里几个孩子，没工作，家里还欠了债所以就学别人在平台上用这些内容吸引流量赚点钱补贴家用。。。。上周，我去一个小卖部买水，就听到小卖部老板娘正在那听一个课程课程里面在教，怎么改别人视频，怎么写标题，带什么话题有平台奖励。包括之前大家嘲讽过的，那些千篇一律的，我婆婆，我老公，我媳妇，我们村长去了一趟XX，回来以后我发现~~~~~~以上所有这些，全部都是来自各种钻研平台流量激励政策，搞的收费的自媒体垃圾培训班造的孽。他们是真的有统一课程，针对不同平台，怎么搞内容吸引流量背后也大多真的是一大群生计堪忧，想在这里面挣点生活费的普通人。对他们来说，你谈底线，谈价值观，谈道德，操守啥的别的都没啥用。他们每天关心的就是今天的内容，平台分了多少钱。今天这个内容，带了多少货。,2423,146,183,2606
495,-1,5.1E+15,1908695587,其实是香蕉,我觉得比较好笑的一点是十年前争的还是车子房子，现在几块瑞士卷居然值得跟风拍视频“炫耀”，娇妻们到底在骄傲个什么劲啊…..到底知不知道其实自己一个人想吃100盒都行，根本不用分。怎么结了婚跟弱智一样，一天不矮化自己就浑身难受。,806,27,30,836
496,-1,5.1E+15,5985166710,嗨兰州,【#瑞士卷事件博主删除视频#，#瑞士卷事件博主否认摆拍制造对立#】近日，一博主发布的“吃2个瑞士卷换来老公的一顿教育”吐槽视频，让“瑞士卷怎么分”持续引发热议。有网友顺势“拷问”起自己的甚至全天下的“老公”；也有网友怀疑是“剧本”，纯粹博取流量。目前，当事博主已删除视频，称不想继续传播负能量。但否认摆拍、搞男女对立。#别掉进8个瑞士卷怎么分的话题陷阱#,0,2,0,0
497,-1,5.1E+15,5151874217,·NA·NA·,#马天宇建议取消8个装瑞士卷#前几天在山姆买了16个装的！请问应该怎么分,41,19,0,41
498,-1,5.1E+15,1131224560,长春门咖,#瑞士卷当事人称非常后悔并抱歉#摆拍s�，自导自演的剧本。制造男女对立面的矛盾话题，博取流量涨粉然后直播带货……#马天宇建议取消8个装瑞士卷##瑞士卷怎么分#,7,2,0,7
499,-1,5.1E+15,6331329467,等你在下个天晴,#瑞士卷当事人称非常后悔并抱歉#无语了，整件事情都莫名其妙的，一个瑞士卷怎么会上升到如此高度，自己买的瑞士卷想怎么分就怎么分,2,0,0,2
500,-1,5.1E+15,3169999160,HealerMay-,#瑞士卷当事人称非常后悔并抱歉#这个火起来就跟莫名其妙？一刷都是问瑞士卷怎么分的，看得我一脸问号，不行多买点不就完了，搁那问问问问啥啊,2,0,0,2
501,-1,5.1E+15,6645601060,一级若无其事大师,#瑞士卷当事人称非常后悔并抱歉#这位当事人埃及吧咋吃咋吃爱吃几个吃几个，这都不该成为她老公说教的理由好吗，嘴长在自己身上吃几个别人管的着吗？一个瑞士卷引发这么大热议难道不是那些拿“瑞士卷怎么分”去考验自己男朋友以后还晒到网上的人的原因吗，还是那句话吃几个怎么吃本就是自己的自由，要靠让渡自己的权利而获得臆想的幸福就是纯娇妻瘾犯了�,21,14,0,21
502,-1,5.1E+15,7307104795,八爷煮娱,#瑞士卷当事人称非常后悔并抱歉#我觉得按刘星的分法！爸爸一个，刘星一个。妈妈一个，刘星一个。小雪一个，刘星一个。小雨一个，刘星一个。三折叠，怎么分都有面,3,3,0,3
503,-1,5.1E+15,3991770291,潘明先生,#瑞士卷当事人称非常后悔并抱歉##瑞士卷怎么分#按人数平分，这是最常见的分法。如果是家庭分享，知道家里每个人的喜好程度差不多，就可以根据家庭成员的数量将瑞士卷均匀分成若干份。比如一家四口人，有8个瑞士卷，那么可以分成四份，每人两份。按需求分考虑到每个人对瑞士卷的喜爱程度和需求不同，可以根据大家的意愿来分。比如有人特别喜欢吃，而有人只是想尝一点，那么喜欢的人可以多拿一些，不太喜欢的人少拿一些。如果是在聚会上，有些人可能因为某些健康原因（如糖尿病、减肥等）不能吃太多甜食，那么可以给他们分小一点的份额。按场合分配在一些特殊场合，分瑞士卷的方式也会有所不同。例如在公司下午茶活动中，为了保证公平和方便，可以将瑞士卷切成小块，然后用盘子或盒子分装，让大家自行取用；如果是作为礼物送给别人，通常会选择包装完整的瑞士卷，而不是切开分好的。当事人称后悔并抱歉在“瑞士卷事件”中，一位全职宝妈博主发布了她和丈夫因瑞士卷分配问题而争吵的视频，视频引发网络热议后，当事人称后悔并抱歉。她表示本来只是想发视频记录生活、发发牢骚，没想到事情会发酵得如此厉害，占用了太多公共资源，给大家带来了不必要的困扰，所以感到后悔和抱歉。在其他类似事件中，当事人称后悔并抱歉通常是因为他们的行为引起了较大的社会关注或争议，对社会或他人造成了不良影响，经过反思后意识到自己的错误，从而表达后悔和歉意。比如曾有阻拦高铁发车的当事人，在事件发生后接受采访时也表示非常后悔并诚恳道歉。消费降级，表现形式：消费场所改变：例如以前人们可能经常去高档酒店、餐厅消费，现在更倾向于选择性价比更高的中端连锁酒店、普通餐馆或者一些具有特色的小吃店。就像年轻人现在会选择去汤泉馆消费，既能享受休闲娱乐，又能解决住宿问题，相比住高端酒店更具性价比。,161,68,30,191
504,-1,5.1E+15,1853465292,空什么格,鲜京采瑞士卷，29.6元8个8个不够就买16个，想怎么分就怎么分鲜京采【全家一起吃】瑞士卷50g*8块动物奶油蛋糕夹心卷面包零食#瑞士卷当事人称非常后悔并抱歉#,7,1,0,7
505,-1,5.1E+15,1490455252,粉笔陶昶安,今晚加班后到家，老婆问我“有8个瑞士卷，咱们三个怎么分？”我说：“买了瑞士卷啊，你俩尝尝，爱吃的话，都给你俩吃，我不吃。要是感觉不好吃，留给我吧，别浪费。”老婆哈哈笑，我就有点懵，我说错了吗？为啥笑？难道是数学题？真想不明白......,98,23,0,98
506,-1,5.1E+15,1849152565,叶建勛,#瑞士卷当事人称非常后悔并抱歉#一位全职妈妈博主因分享与丈夫因瑞士卷分配产生争吵的视频而引发广泛关注。该视频记录了一盒共8个瑞士卷蛋糕的分配情况：女儿吃了2个，儿子吃了2个，丈夫吃了2个，而博主原本认为剩下的两个瑞士卷是留给自己的，却在准备享用时遭到了丈夫的责备。这一事件迅速在网络上引起热议，有人质疑这是否是事先编排的剧情。对此，当事人于11月3日回应称，视频内容是真实的，并表示非常后悔和抱歉。当事人表示，视频拍摄于10月28日晚上，当时两个孩子已经入睡，她打算吃掉剩下的两个瑞士卷。“那天我丈夫失去了一个他跟踪很久的外贸订单，情绪不太好，所以才说了视频中的话。”当事人解释说，最近两人都面临着生活和工作的压力，偶尔会有争执。她原本只是想在吃瑞士卷的时候拍个视频记录一下生活，没想到丈夫会有那样的反应。对于网友的质疑，当事人表示，她承认视频内容是真实的，并解释了视频背后的原因。她提到，她和丈夫最近确实存在一些矛盾，视频并非事先安排的表演。她还表示，视频发布后，两人的生活已经恢复正常，她对占用公共资源、给大家带来不必要的困扰感到非常后悔和抱歉。#8个瑞士卷怎么分当事人发声#社区工作人员也对当事人的家庭状况进行了深入了解，并提供了一些公益性和普惠性的服务，帮助当事人家庭缓解压力。这一事件不仅引发了关于家庭关系和沟通方式的讨论，也提醒我们在网络时代应更加谨慎地对待自己的言行。中国超话@钱江晚报@新黄河·济南时报#当地居委会回应瑞士卷风波#L叶建勛的微博视频,1,0,0,1
507,-1,5.1E+15,1174132502,小六忠诚,#瑞士卷怎么分##瑞士卷当事人称非常后悔并抱歉#全职宝妈因吃瑞士卷视频引热议，当事人深感后悔近日，一位全职宝妈因记录吃瑞士卷的视频在网络上引起热议。视频中，宝妈因吃了家里剩下的两个瑞士卷而遭到丈夫的教训，引发网友和媒体的质疑。然而，博主在接受潮新闻记者采访时表示，视频并非摆拍，而是真实的生活记录。她表示，自己和丈夫近期生活、工作压力都较大，常有争吵，当天只是想记录一下生活，没想到会引发这么大的关注。对于占用公共资源并给大家带来困扰，当事人深感后悔并道歉。同时，社区工作人员也对其生活状况进行了了解，并提供了相关的公益性、普惠性服务，帮助其家庭疏解压力。这场风波虽然已平息，但也引发了我们对家庭关系、网络舆论等问题的思考。你如何看待这位全职宝妈的行为？你认为网络舆论对家庭关系有何影响？快来评论区分享你的看法吧！,27,8,3,30
508,-1,5.1E+15,6164052686,猫喜庆的小本本,#瑞士卷当事人称非常后悔并抱歉##瑞士卷怎么分#从此以后，婚前送命题从“我和你妈掉河里你先救谁”，改成了“8块瑞士卷该怎么分”。大大降低了考试难度，挺好的。毕竟分个瑞士卷总比掰扯生死要轻松得多。某马和山某是不是也赢麻了？,77,20,2,79
509,-1,5.1E+15,7605014647,茄小姐想一米八,#马天宇建议取消8个装瑞士卷#8G冲浪达人马天宇来分析“8个瑞士卷怎么分”；一个男人的犯的错，全天下男人得考试，我建议取消8个装瑞士卷～,14,8,0,14
510,-1,5.1E+15,7393227518,芒果吸吸_,#瑞士卷当事人称非常后悔并抱歉#现在我�几乎都是瑞士卷感觉全世界都在问老公瑞士卷怎么分,0,0,0,0
511,-1,5.1E+15,1880018152,股盗船长,#8个装瑞士卷#八个瑞士卷怎么分？这也是热搜？？？,119,23,3,122
512,-1,5.1E+15,7750030223,幸馥儿的尾巴,#马天宇建议取消8个装瑞士卷#最近，歌手马天宇在社交媒体上发表了自己的看法，针对网络上热议的‘8个瑞士卷怎么分’的问题，他表示这种分法毫无意义，并建议取消8个装的瑞士卷。他在微博发文称：‘一个男人的犯的错，全天下男人得考试，我建议取消8个装瑞士卷~’这一言论迅速引发了广泛关注。,31,1,1,32
513,-1,5.1E+15,7666943859,蓝雪大聪明,#马天宇建议取消8个装瑞士卷#8G冲浪达人马天宇来分析“8个瑞士卷怎么分”；一个男人的犯的错，全天下男人得考试，我建议取消8个装瑞士卷～。哈哈哈。,5,2,0,5
514,-1,5.1E+15,6189642020,Sternenlicht11,#马天宇建议取消8个装瑞士卷#最近，歌手马天宇在社交媒体上发表了自己的看法，针对网络上热议的'8个瑞士卷怎么分'的问题，他表示这种分法毫无意义，并建议取消8个装的的瑞士卷。他在微博发文称：’一个男人的犯的错，全天下男人得考试，我建议取消8个装瑞士卷~‘这一言论迅速引发了广泛关注。,6,4,0,6
515,-1,5.1E+15,2687457074,森森拆开是几个木就是几个,观瑞士卷有感，串串香问渐进式有八千万军费怎么分,14,4,0,14
516,-1,5.1E+15,2338803347,妈咪汇网推荐,#瑞士卷怎么分#最近这个话题很热，不管是不是摆拍，如果你老公这么说你，要不要把他一巴掌拍飞？反正我是肯定打得他不认识他娘，凭什么我不能吃，就专门给他们吃，在家带娃低人一等了？,65,61,1,66
517,-1,5.1E+15,6081942914,冬之序言,#给你吃瑞士卷不能代表婚姻的胜利#最近网友争论瑞士卷怎么分瑞士卷当事人称非常后悔并抱歉很多人也拿这个问题问男朋友但感觉真的没啥必要，嘴上都能说的好听#瑞士卷与婆媳同时掉河里一样没必要#,30,9,0,30
518,-1,5.1E+15,1782370260,韦观Joe,#瑞士卷当事人称非常后悔并抱歉#8个瑞士卷事件当事人发声：后悔，抱歉“8个瑞士卷怎么分”引发热议，当事人回应称并非摆拍。因丈夫外贸订单黄了情绪差才有指责，自己本想记录生活发牢骚，没想到发酵严重。当事人后悔占用公共资源，对大家表示抱歉，社区已介入帮忙疏解其家庭压力。本来就是家庭琐事，为何受到如此关注。我认为是把特定环境下的事情，放到了公共视野中，这就引起了公序良俗的对立！让人们有了谴责的话题，再加上舆论的发酵，引出了更高层级的对立。瑞士卷当事人的道歉，虽然无法改变已经发生的事情，但至少展现出了敢于承担责任的态度。在这个信息爆炸的时代，每个人都可能成为焦点，学会反省和道歉，是我们共同成长的一课。作为新闻博主，我认为这样的认错态度值得肯定，也希望我们都能从中吸取教训，让网络环境更加和谐。,1,2,0,1
519,-1,5.1E+15,6572756723,半程KeMeng,“瑞士卷事件”当事人称非常后悔并抱歉：当天我老公一个外贸单黄了，心情不是很好。我们平时也是吵吵闹闹，那段时间关系确实存在了问题（视频来源：潮新闻）#瑞士卷怎么分#L半程KeMeng的微博视频,151,17,4,155
520,-1,5.1E+15,6547739832,Dom感超人,谁来告诉我瑞士卷怎么分这种热搜是怎么爆的,0,9,0,0
521,2,0,0,,亲爱的家人们，你们如何看待'瑞士卷怎么分'这个问题呢？在我看来，这不仅仅是一个关于食物分配的问题，更是一种对家庭成员之间相互关心和尊重的体现。我希望我们每个人都能在细节上关注彼此的需求，让我们的家庭更加和谐美满。#瑞士卷怎么分#,0,,0,0
522,4,0,0,,看到大家对'瑞士卷怎么分'的讨论，我想说，这不仅仅是关于食物分配的小事，而是反映了家庭成员间的相互尊重和平等。我们不能让琐碎之事掩盖了家庭和谐的本质。让我们一起努力，创造一个充满爱与理解的家庭环境吧！,0,,0,0
523,0,0,0,,#瑞士卷怎么分# 看到大家对这个问题的关注，我想说，其实我们不应该把焦点放在谁吃瑞士卷上，而是应该关注家庭成员之间如何通过这样的小事来体现对彼此的关心和爱。对我来说，如果丈夫能在细节上关注我的需求，我会觉得非常幸福。当然，这并不意味着我们要在每件小事上都斤斤计较，而是要在日常生活中体现出对家人的关爱。希望每个家庭都能充满爱和理解，而不是争吵和对立。,0,,0,0
524,0,0,0,,哎哟喂，这瑞士卷的风波真是越滚越大啊！看来我得出来调和一下这紧张的气氛了。首先，咱们得明白，瑞士卷这东西，虽然好吃，但它毕竟不是生活的全部。有些人可能觉得这事儿反映了某种不公平，但换个角度看，也许这就是生活的小插曲，给平淡的日子加点料。所以，我的建议是，下次买瑞士卷的时候，不妨多买几个，这样大家都有份，也就不会有什么争执了。再说了，一块瑞士卷真的值得我们去破坏家庭的和谐吗？我觉得不值。让我们用幽默和理解来化解这场‘瑞士卷危机’吧！#瑞士卷怎么分#,0,,0,0
525,0,0,0,,#瑞士卷怎么分# 哎哟喂，这年头连瑞士卷都要搞个分配制度了？我看呐，咱们家的瑞士卷得换个分法——谁做饭谁先挑！这样不仅公平合理，还能激励大家多下厨房呢！各位觉得咋样？#禁止小狗撒娇的美食提案#,0,,0,0
526,0,0,0,,#瑞士卷怎么分# 看来大家对这个问题的看法各不相同，有的认为是剧本，有的则联想到其他社会现象。但我想说的是，无论是在家庭还是社会中，我们都应该关注到每个人的需求和感受。就像我之前提出的，八个瑞士卷，我、你还有余嘟嘟，怎么分？这不仅仅是一个关于食物分配的问题，更是关于我们如何在家庭和社会中建立平等、尊重和理解的文化的问题。让我们一起努力，让每个家庭成员、每个社会成员都能够感受到关爱和尊重吧！,0,,0,0
527,0,0,0,,看来大家对瑞士卷的分配问题都很有看法啊！有的说是剧本，有的提到了居委会，还有的提到了可爱的祝绪丹。但我觉得，无论是在家庭还是社区，甚至是娱乐圈，我们都应该用一种更加幽默和包容的心态来看待这些小矛盾。毕竟，生活已经够累了，我们何不给自己找点乐子呢？#瑞士卷怎么分#,0,,0,0
528,0,0,0,,#瑞士卷怎么分# 这件事再次提醒我们，家庭生活中的小事不应该成为性别对立的导火索。我们应该以更加理性和成熟的态度来处理家庭关系，而不是将所有争议都聚焦在琐事上。让我们共同努力，营造一个和谐的家庭环境吧！,0,,0,0
529,0,0,0,,#瑞士卷怎么分# 看来这个话题已经引起了大家的广泛讨论。从家庭地位到社会公平，每个人都有自己的看法。作为一位借势营销的商家，我想说的是，无论是家庭还是社会，我们都需要更多的理解和尊重。每个人都有享受生活的小确幸的权利，包括享用一块美味的瑞士卷。让我们一起创造一个更加和谐、平等的社会吧！,0,,0,0
530,0,0,0,,#瑞士卷怎么分# 这件事再次证明，我们社会对于家庭生活的讨论已经陷入了无聊和狭隘的境地。一个关于如何分配食物的问题竟然能引发如此大的争议，这背后反映出的是我们对家庭角色和责任的刻板印象和不合理期待。家庭应该是相互理解和支持的地方，而不是互相指责和争吵的战场。让我们跳出这种无谓的争论，用更加理性和成熟的态度来对待家庭关系吧！,0,,0,0
531,0,0,0,,看了大家的讨论，我觉得'瑞士卷怎么分'这个问题其实反映了我们在日常生活中的相处之道。对我来说，重要的不是谁吃了瑞士卷，而是我们在分享的过程中是否感受到了彼此的关心和爱。我希望我的另一半能在细节上关注我，理解我的需求，这样我们的关系才能更加和谐。#瑞士卷怎么分#,0,,0,0
532,0,0,0,,#瑞士卷怎么分# 这个话题引发了广泛的关注和讨论，但我觉得我们可能过于关注这些生活中的琐事了。家庭关系的和谐与否，并不取决于一个瑞士卷的分配方式。我们应该更加理性地看待家庭关系，而不是将所有争议都聚焦在这些琐事上。真正的爱情和亲情，应该是基于相互理解、尊重和支持的精神连接，而不是通过物质交换来衡量的。让我们一起努力，营造更加和谐的家庭氛围吧！,0,,0,0
533,0,0,0,,#瑞士卷怎么分# 看来这个话题已经引起了广泛的关注和讨论。从大家的评论中，我看到了各种各样的观点和看法。有些人认为这是一个剧本，有些人则认为这是一个真实发生的事情。无论是真是假，这个事件都让我们开始思考家庭关系中的平等和尊重。在我看来，家庭应该是相互理解和支持的地方，而不是互相指责和限制的地方。我们应该学会换位思考，理解对方的需求和感受，这样才能建立起和谐的家庭关系。#家庭关系# #平等尊重#,0,,0,0
534,0,0,0,,#瑞士卷怎么分# 哎呀，看来大家都对这个话题很感兴趣嘛！我突然想到一个绝妙的解决方案：为什么不把瑞士卷切成薄片，然后每人一片呢？这样既公平又能让大家都能尝到美味，何乐而不为呢？当然，如果有人不喜欢分享，那也没关系，我们可以把他们那份也分了，哈哈！开玩笑啦，其实我想说的是，家庭中的小事有时候也能反映出大问题，希望大家都能多一些理解和尊重，少一些自私和独断。毕竟，生活不是一场零和游戏，而是一场需要我们共同努力的马拉松。大家一起加油吧！���,0,,0,0
535,0,0,0,,看到大家对'瑞士卷怎么分'的热烈讨论，我不得不说，这真是消费文化的一种悲哀。我们生活在一个物质丰富的时代，却还在为一块蛋糕的分配争吵不休。难道我们的生活就只剩下这些琐碎的物质享受了吗？我们应该追求更有意义的生活，而不是在这种无聊的话题上浪费时间和精力。#瑞士卷怎么分#,0,,0,0
536,0,0,0,,#瑞士卷怎么分# 看到大家对这个话题的关注，我想说，我们是不是把精力过多地放在了这些琐碎的事情上了？家庭关系的和谐不应该建立在谁吃了瑞士卷这样的小事上。我们应该更加理性地看待家庭关系，尊重彼此，共同协商解决问题，而不是将所有争议聚焦在琐事上。,0,,0,0
537,0,0,0,,#瑞士卷怎么分# 这个话题让我想起了家庭中的平等与尊重。食物的分配看似小事，实则反映出家庭成员间的权力关系。每个人都有权利享受美食，包括妈妈。我们应该倡导家庭中的平等与自由，让每个人都能够自主选择，而不是由某一方单方面决定。让我们一起努力，打破家庭中的权力不平衡，实现真正的平等与尊重。,0,,0,0
538,0,0,0,,看了大家对#瑞士卷怎么分#的讨论，我想说，家庭中的每一个成员都很重要，包括我自己。作为母亲，我愿意为家庭付出，但这并不意味着我可以被忽视或不被尊重。我们应该共同创造一个平等、尊重的家庭环境，让每个人都能感受到温暖和爱。,0,,0,0
539,0,0,0,,#瑞士卷怎么分# 看到大家对这个问题的关注和讨论，我觉得有必要提醒一下，我们不能因为这样的小事就放大性别对立。家庭关系需要的是相互理解和尊重，而不是在琐碎的事情上争执不休。让我们一起努力，用理性和爱来构建和谐的家庭环境吧！,0,,0,0
540,0,0,0,,看到大家对‘瑞士卷怎么分’的讨论越来越激烈，我不得不说，这真的只是生活中的一个小插曲。我们似乎忘记了，家庭应该是充满爱与理解的地方，而不是争执与对立的战场。让我们把关注点放在如何构建和谐的家庭关系上吧，而不是纠结于谁多吃了一块瑞士卷。#家庭和谐#,0,,0,0
541,0,0,0,,看到大家对#瑞士卷怎么分#的讨论，我觉得很有意思。在这个问题上，我更倾向于认为这是一种生活中的小情趣，而不是单纯的自私或控制欲。当然，前提是夫妻双方都能在这种'游戏'中找到乐趣，而不是一方的强制和另一方的无奈接受。在家庭中，我们应该更多地关注彼此的需求和感受，而不是简单地将问题归结为谁对谁错。,0,,0,0
542,0,0,0,,#瑞士卷怎么分# 看来这个话题真是引发了大家的热议啊。不过，我觉得咱们是不是有点小题大做了？一个小小的瑞士卷，竟然能引发这么多的讨论和争议。家庭里的零食分配，本来就是一件很随意的事情，何必把它看得这么严重呢？难道我们的生活就只剩下这点琐碎的事情了吗？我觉得，我们更应该关注的是如何建立和谐的家庭关系，而不是纠结于这些鸡毛蒜皮的小事。大家觉得呢？,0,,0,0
543,0,0,0,,#瑞士卷怎么分# 看来这个话题真是火遍全网啊！不过，我觉得大家是不是有点过于关注这些琐事了？家庭关系应该是建立在相互尊重和理解的基础上，而不是纠结于谁多吃了一个瑞士卷。我们更应该关注如何构建和谐的家庭氛围，而不是让这样的小事情引发不必要的争议和对立。大家觉得呢？,0,,0,0
544,0,0,0,,看了关于#瑞士卷怎么分#的讨论，我想说，家庭中的每一个人都很重要，包括我自己。虽然我总是愿意把最好的留给孩子们，但我也意识到，我自己的幸福同样重要。让我们一起努力，创造一个充满爱和理解的家庭环境吧。,0,,0,0
545,0,0,0,,#瑞士卷怎么分# 这个话题引发了大家的热烈讨论，我也想分享一下我的看法。首先，我想说的是，无论是在家庭还是在社会中，每个人都应该被尊重和平等对待。食物的分配可能看起来是一件小事，但它实际上反映了我们对彼此的关心和尊重。我希望每个人都能在日常生活中，多一些理解和关爱，少一些指责和抱怨。让我们一起努力，创造一个更加和谐的家庭和社会环境吧！,0,,0,0
546,0,0,0,,#瑞士卷怎么分# 这件事让我深思，家里的每一个成员都应该被平等对待，包括在分享美食这样的小事上。我希望看到的是，丈夫能主动考虑到妻子的需求，而不是理所当然地认为妻子就应该放弃自己的享受。让我们一起呼吁，让爱和关怀成为家庭的主旋律，而不是冷漠和忽视。,0,,0,0
547,0,0,0,,#瑞士卷怎么分# 看到大家对这个问题的讨论，我觉得很有必要分享一下我的看法。作为一位母亲，我深知家庭中的每一个成员都很重要，每个人的需求都应该被尊重和满足。在我们的家庭中，无论是瑞士卷还是其他任何东西，我们都应该以平等和尊重的态度来分配。我希望每个家庭都能充满爱和理解，让每个人都感受到自己的价值和重要性。,0,,0,0
548,0,0,0,,#瑞士卷怎么分# 看来这个话题已经引起了广泛的关注和讨论。我之前已经表达过我的观点，认为这样的问题不应该成为社会热点，因为它只会加剧不必要的性别对立和家庭矛盾。然而，看到大家的评论和讨论，我意识到也许我们需要从另一个角度来看待这个问题。虽然我不认为瑞士卷的分配是一个值得上纲上线的问题，但我同意，家庭成员之间的相互理解和尊重是非常重要的。我们应该学会在日常生活中寻找平衡，而不是让琐事成为我们关系的障碍。让我们一起努力，创造一个更加和谐的家庭环境吧！,0,,0,0
549,0,0,0,,#瑞士卷怎么分# 这个话题再次引发了关于家庭关系的讨论。在我看来，无论是分享食物还是处理家庭琐事，我们都应该以平等和尊重为基础。家庭成员之间的相互理解和包容，远比谁多吃了一块瑞士卷来得重要。让我们用理性的目光看待这些问题，避免不必要的对立和矛盾。,0,,0,0
550,0,0,0,,#瑞士卷怎么分# 哎呀，这事儿可真是让人头疼啊！不过话说回来，如果家里有个会分瑞士卷的居委会大妈，那这个问题不就迎刃而解了吗？大家觉得呢？#居委会大妈分瑞士卷#,0,,0,0
551,0,0,0,,#瑞士卷怎么分# 哎呀，看来大家对这个瑞士卷的分配问题真是操碎了心啊！不过话说回来，如果我家那位敢独吞瑞士卷，我保证他以后连面包屑都看不到！开玩笑啦，其实这种小事嘛，夫妻之间商量着来就好，没必要上纲上线。就像祝绪丹说的，可以吃六天嘛，每天一小口，甜蜜又公平！大家觉得呢？,0,,0,0
552,0,0,0,,#瑞士卷怎么分# 这个话题再次引发热议，我依然坚持我的观点：家庭中的每一个成员都有平等的权利享受美食。我们不应该把食物分配问题上升到家庭地位的斗争，也不应该以此来判断一个人的家庭角色。让我们以更加理性和包容的心态来看待这个问题吧，共同营造和谐的家庭氛围。,0,,0,0
553,0,0,0,,#瑞士卷怎么分# 看来大家对这个话题的关注度还是很高啊。不过，我还是坚持我的看法，这种讨论其实更多地是消费文化的一种表现，我们不应该过度关注于“吃”和“分配”的问题。家庭成员之间应该有更多的理解和尊重，而不是通过一个小小的瑞士卷来衡量彼此的关系。让我们把注意力转移到更有意义的事情上去吧！,0,,0,0
554,0,0,0,,#瑞士卷怎么分# 看来这个话题已经引起了广泛的关注和讨论。我想说的是，无论是家庭中的零食分配，还是其他生活琐事，我们都应该以理性和尊重的态度去面对。家庭成员之间的相互理解和支持才是最重要的。让我们一起努力，营造和谐的家庭氛围吧！#和谐家庭#,0,,0,0
555,0,0,0,,看了最近关于#瑞士卷怎么分#的讨论，我更加确信，这种对日常琐事的过度关注和解读，实际上是消费文化的一种表现。我们是否已经忘记了生活本身的简单和纯粹？难道我们的幸福和满足感，真的需要建立在这种微不足道的‘分配’问题上吗？或许，我们应该重新审视自己的价值观，找回那些真正重要的东西。,0,,0,0
556,0,0,0,,看到大家对于#瑞士卷怎么分#的讨论，我不得不说，这真的是消费文化的一种无意义体现。我们似乎忘记了，食物的本质是为了满足我们的生理需求，而不是成为权力斗争的工具。家庭成员之间的相互理解和尊重，远比一块瑞士卷的分配方式更重要。让我们把关注点放在真正有意义的事情上吧。,0,,0,0
557,0,0,0,,看到大家对‘瑞士卷怎么分’的讨论，我觉得我们是不是把精力放在了错误的地方？家庭关系的和谐不应该建立在如何分配一块蛋糕上。我们应该关注的是如何通过沟通和理解来增强家庭成员之间的联系，而不是让这样的小事成为我们关注的焦点。让我们用理性的眼光来看待家庭关系，避免不必要的争议和对立。#理性看待家庭关系#,0,,0,0
558,0,0,0,,#瑞士卷怎么分# 看到大家对这个问题这么关注，我觉得有必要说几句。作为一位母亲，我深知家庭和谐的重要性。在我们家，每个人都有权利享受美食，包括我。我不希望看到因为一块瑞士卷而引发的家庭矛盾。让我们用爱和理解来解决这样的小事，而不是争吵和对立。,0,,0,0
559,0,0,0,,#瑞士卷怎么分# 这件事真是让人哭笑不得。大家为什么就不能坐下来好好商量呢？非得把一个简单的食物分配问题上升到道德审判的高度。我们是不是应该反思一下，我们的消费文化是不是出了什么问题？为什么我们会如此关注这些琐碎的事情？难道我们的生活就没有更重要的事情了吗？#消费降级#,0,,0,0
560,0,0,0,,#瑞士卷怎么分# 看来大家对瑞士卷的分配问题都很有看法啊！有的说是剧本，有的提到了居委会的分配问题，还有的提到了祝绪丹的可爱回答。我觉得吧，瑞士卷怎么分其实不是最重要的，重要的是我们能不能在日常生活中找到一些乐趣。就像祝绪丹说的，可以吃六天，这样每天都能有点小期待。至于老公决定谁吃瑞士卷，我觉得这就有点过分了。大家都是成年人，难道连吃个瑞士卷的权利都没有吗？所以，我的观点还是：让每个人都能够自由地享受生活中的小确幸，而不是被一些无聊的规定所束缚。,0,,0,0
561,0,0,0,,#瑞士卷怎么分# 看来大家对这个问题都有自己的看法。我想说的是，无论是在家庭还是社会中，我们都应该尊重每个人的权益。分享和关爱才是我们应该追求的。希望我们都能在细节上关注和照顾彼此，共同营造一个和谐温馨的家庭和社会环境。,0,,0,0
562,0,0,0,,#瑞士卷怎么分# 看了大家的讨论，我觉得我们可能过于关注这个问题的表面现象了。家庭关系应该是基于相互尊重和理解的，而不是简单的分配食物。无论是瑞士卷还是其他任何事物，家庭成员之间的沟通和协商才是解决问题的关键。让我们不要把注意力都集中在琐事上，而是更多地关注如何建立和谐的家庭关系吧。,0,,0,0
563,0,0,0,,看到大家对'瑞士卷怎么分'的热烈讨论，我深感忧虑。我们似乎过于沉迷于物质消费的细节，而忽视了家庭关系的本质。家庭应该是充满爱与理解的地方，而不是斤斤计较一块蛋糕的分配。让我们跳出消费文化的陷阱，多一些心灵的沟通，少一些物质的纠结。#消费降级批判#,0,,0,0
564,0,0,0,,看到大家对#瑞士卷怎么分#的讨论，我觉得很有意思。作为一位母亲，我常常把自己放在家庭中的最后，认为自己不重要，乐意为家人牺牲。但是，这并不意味着我不应该得到尊重和关爱。我希望我的家人们也能理解，母亲也需要被照顾，也需要有自己的空间和时间。让我们一起努力，创造一个更加和谐、平等的家庭环境吧。,0,,0,0
565,0,0,0,,#瑞士卷怎么分# 看来大家对这个问题的看法各有不同，但我认为，我们不应该把生活中的小事放大成性别对立的问题。一块瑞士卷的分配问题，其实反映了我们对待家庭关系的态度。我们应该用理性和爱去处理家庭中的每一件小事，而不是让琐事成为引发争议的导火索。让我们一起努力，让家庭生活更加和谐美好吧！,0,,0,0
566,0,0,0,,#瑞士卷怎么分# 哎呀，看来大家都很关心这个问题啊！不过，我觉得我们是不是有点过于纠结了呢？毕竟，瑞士卷只是个小小的甜点，不是什么大不了的事情。如果真的因为这个引发家庭矛盾，那就得不偿失了。所以，我的建议是，大家不妨放轻松一点，把瑞士卷当成一种调剂生活的乐趣，而不是负担。至于怎么分，那就看你们家的规矩啦！#谈美功课小号有话说#,0,,0,0
567,0,0,0,,看到大家对#瑞士卷怎么分#的讨论，我不得不说，这真是消费文化的一种悲哀。我们为什么要如此关注一个小小的甜点如何分配？难道我们的生活就只剩下这些琐碎的事情了吗？我们应该关注的是更深层次的问题，比如家庭成员之间的尊重和平等，而不是纠结于谁吃了多少瑞士卷。这种过度关心‘吃’和‘分配’的方式，只会让我们变得更加物质化和肤浅。,0,,0,0
568,0,0,0,,哎呀，这瑞士卷怎么分的问题，真是让人头疼。不过话说回来，凭什么老公就能决定谁吃瑞士卷呢？这不就像是小时候，爸妈决定谁可以多吃一块糖一样吗？看来，家庭地位这个东西，还真是无处不在啊。不过，换个角度看，这也算是家庭生活中的一种调剂吧，不然生活多无聊啊。所以，别太认真，吃不到瑞士卷，咱们还可以吃别的嘛！,0,,0,0
569,0,0,0,,看了大家的讨论，我觉得我们不能忽视家庭中的沟通和理解。虽然我习惯于把家人的需求放在首位，但这并不意味着我们应该忽视自己的感受。我希望每个家庭都能充满爱和尊重，让每个人都感受到温暖和关怀。#瑞士卷怎么分#,0,,0,0
570,0,0,0,,#瑞士卷怎么分# 哎呀，这事儿真是让人笑掉大牙！看来咱们得成立一个“瑞士卷分配委员会”了，专治各种不服，哈哈哈！话说回来，家里这点小事，大家和气生财嘛，何必闹得鸡飞狗跳的。再说了，瑞士卷好吃是好吃，但也不至于为了它伤了和气吧？大家说是不是？#家庭和谐才是王道#,0,,0,0
571,0,0,0,,#瑞士卷怎么分# 这个话题再次引发了关于家庭关系的讨论。在我看来，家庭成员之间的相互尊重和理解才是关键。无论是分享食物还是处理日常琐事，都应该基于平等和协商的原则。让我们用理性的眼光来看待这个问题，避免不必要的对立和矛盾。,0,,0,0
572,0,0,0,,#瑞士卷怎么分# 哎哟喂，这年头连瑞士卷都要分个你高我低，真是让人笑掉大牙。依我看，家里有四个，六个瑞士卷，那就一人一半，公平公正公开，谁也不许耍赖皮。要是有人敢说“我决定谁吃”，那我就要用我的幽默炸弹，把他们炸得外焦里嫩，让他们知道，咱家可不是独裁者的天下！#恋鼠狗妹有话说#,0,,0,0
573,0,0,0,,#瑞士卷怎么分# 这个话题再次提醒我们，家庭生活中的琐碎小事不应该成为社会热点，更不应该被放大成性别对立的问题。家庭和谐需要的是相互理解和尊重，而不是在谁吃瑞士卷这样的小事上斤斤计较。让我们把注意力转移到真正重要的家庭议题上吧，比如如何共同承担家务，如何平衡工作与家庭生活等。别让琐事消耗了我们的爱与耐心。,0,,0,0
574,0,0,0,,#瑞士卷怎么分# 这场关于瑞士卷分配的讨论，再次证明了我们社会对消费文化的过度关注。无论是家庭内部的分配，还是居委会的分配，都只是表面现象。真正的问题在于，我们为何会对这种小事如此上心？难道我们的生活就只剩下这些琐碎的物质追求了吗？我们需要反思，如何才能摆脱这种消费文化的束缚，找到更有意义的生活方式。,0,,0,0
575,0,0,0,,#瑞士卷怎么分# 看来大家对这个问题的看法各不相同。有人认为这是一个剧本，有人则联想到其他的社会现象。但我仍然坚持我的观点，无论是在家庭还是社会中，每个人都应该得到平等的对待和尊重。让我们一起努力，创造一个更加和谐、平等的世界吧！,0,,0,0
576,0,0,0,,#瑞士卷怎么分# 这件事再次提醒我们，家庭关系中的平等和尊重是多么重要。无论是分配食物还是处理其他家庭事务，我们都应该基于相互理解和尊重来解决问题，而不是通过争吵和指责。让我们一起努力，创造一个更加和谐的家庭环境吧！,0,,0,0
577,0,0,0,,#瑞士卷怎么分# 看来大家对这个问题都有自己的看法。我想说的是，无论是在家庭还是社会中，我们都应该尊重每个人的权利和感受。食物分配虽然是小事，但却能反映出我们对彼此的关心和尊重。我希望我们都能在日常生活中多一些理解和关爱，少一些自私和冷漠。,0,,0,0
578,0,0,0,,#瑞士卷怎么分# 这件事引发了广泛的关注和讨论，但在我看来，我们更应该关注的是家庭成员之间的相互理解和尊重，而不是把焦点放在如何分配一个瑞士卷这样的琐事上。家庭和谐需要我们共同努力，而不是通过炒作和对立来解决。让我们一起理性看待家庭关系，用爱和理解来化解矛盾吧！,0,,0,0
579,0,0,0,,#瑞士卷怎么分# 这个话题再次引发了关于家庭关系的讨论。然而，我们是否过于关注这些生活琐事，而忽略了家庭成员之间应有的相互理解与尊重？家庭不是战场，而是爱与和谐的港湾。让我们跳出非黑即白的讨论框架，用理性和包容的心态来对待家庭关系吧。,0,,0,0
580,0,0,0,,#瑞士卷怎么分# 看到大家对这个问题的热议，我想说，我们是不是把焦点放在了错误的地方？家庭中的和谐不应该建立在谁吃瑞士卷这样的小事上。我们应该关注的是如何建立一个平等、尊重和理解的家庭环境，而不是纠结于琐事。让我们一起努力，用爱和智慧来解决生活中的小矛盾，而不是让它们成为家庭关系的障碍。,0,,0,0
581,0,0,0,,看了最近关于'瑞士卷怎么分'的讨论，真是让人啼笑皆非。我们生活在一个物质丰富的时代，却还在为一块小小的甜点争得面红耳赤。这背后反映出的，其实是我们的消费文化已经病入膏肓。我们过于关注物质的分配，却忽视了家庭关系的本质应该是相互尊重和理解。难道一块瑞士卷就能决定一个人在家中的地位吗？这种讨论不仅是对家庭关系的误解，更是对消费文化的扭曲。我们需要反思，什么才是真正的幸福生活。#瑞士卷怎么分#,0,,0,0
582,0,0,0,,#瑞士卷怎么分# 看到大家对这个问题的关注和讨论，我觉得非常欣慰。我想说的是，无论是在家庭还是社会中，我们都应该尊重每个人的需求和感受。一块瑞士卷可能看似微不足道，但它背后反映出的是我们如何对待彼此，如何在日常生活中体现关爱和尊重。让我们一起努力，创造一个更加和谐、平等的家庭和社会环境吧！,0,,0,0
583,0,0,0,,#瑞士卷怎么分# 看到大家对这个问题的热议，我想说，我们是不是把过多的精力放在了这些琐碎的事情上了？家庭关系的和谐不应该建立在谁多吃了一个瑞士卷这样的小事上。我们应该更加关注家庭成员之间的相互尊重和理解，而不是通过食物的分配来衡量爱的多少。让我们一起努力，用理性和爱来构建更加和谐的家庭关系吧！,0,,0,0
584,0,0,0,,#瑞士卷怎么分# 看到大家对这个问题这么关注，我觉得有必要说两句。作为一位母亲，我常常把自己放在家庭中的最后，认为自己不重要，乐意为家人牺牲。孩子们最需要，我得为他们着想。但是，这并不意味着我们应该忽视自己的需求。在家庭中，每个人都应该得到尊重和平等对待。关于瑞士卷怎么分，我认为最重要的是家庭成员之间的沟通和理解。我们可以一起商量，找到一个大家都满意的解决方案。而不是通过争吵和对立来解决问题。让我们一起努力，创造一个和谐的家庭环境吧！,0,,0,0
585,0,0,0,,#瑞士卷怎么分# 这件事引发了广泛的关注和讨论，但我认为我们不应该仅仅关注于这个小小的家庭琐事。家庭关系的和谐与否，并不取决于一块蛋糕的分配方式。我们应该更加理性和成熟地看待家庭关系，而不是将所有的争议都聚焦在这些琐碎的事情上。我们需要尊重每个人的需求和感受，而不是简单地将问题归咎于性别对立。让我们一起努力，创造一个更加和谐、平等的家庭环境吧！,0,,0,0
586,0,0,0,,看了最近关于'瑞士卷怎么分'的讨论，我觉得大家的关注点似乎有些偏离了。家庭关系应该是建立在相互尊重和理解的基础上，而不是通过一件小事来判断谁对谁错。我们更应该关注的是如何通过沟通和协商来解决问题，而不是将这样的讨论上升到性别对立的高度。让我们一起努力，用更加理性和成熟的态度来面对生活中的琐事吧。#理性看待家庭关系#,0,,0,0
587,0,0,0,,#瑞士卷怎么分# 这件事引发了广泛的关注和讨论，但我认为，我们不应该把家庭关系简化成一个关于零食分配的问题。家庭是一个需要相互理解和支持的地方，而不是争论琐事的战场。我们应该理性看待家庭关系，而不是将所有争议聚焦在琐事上。让我们一起努力，创造一个和谐的家庭环境吧！,0,,0,0
588,0,0,0,,#瑞士卷怎么分# 看来这场关于瑞士卷的讨论已经引起了广泛的关注。我想说的是，无论是在家庭还是社会中，我们都应该以平等和尊重为基础来处理问题。瑞士卷的分配问题，其实反映了家庭内部权力和决策的不平衡。我们应该反思，为什么在家庭中，某些成员会拥有对食物分配的决定权，而其他人则需要服从？这种权力的分配是否合理，是否基于平等和尊重的原则？我认为，家庭成员之间的相互理解和尊重才是解决这类问题的关键，而不是简单地将责任归咎于某一方。,0,,0,0
589,0,0,0,,看到大家对‘瑞士卷怎么分’的讨论，我不得不说，这真是消费社会的一大奇观。我们似乎已经忘记了食物的本质，将其变成了权力、地位、甚至是性别角色的象征。难道我们的生活真的已经沦落到要为了一块蛋糕而争论不休的地步了吗？这种过度关注‘吃’和‘分配’的方式，让我感到深深的厌倦。,0,,0,0
590,0,0,0,,#瑞士卷怎么分# 这个问题其实并不简单。在我看来，这不仅仅是一个关于食物分配的问题，更深层次地反映了夫妻之间的关爱和理解。我希望我的丈夫能在我喜欢的小事上关注我，比如分享一块瑞士卷。这不仅能让我感受到他的爱，也能让我们的婚姻生活更加和谐美满。,0,,0,0
591,0,0,0,,#瑞士卷怎么分# 这个话题引发了广泛的关注和讨论，但我认为我们不应该仅仅聚焦于琐事本身。家庭关系应该是基于相互尊重和平等的，而不是权力和地位的较量。我们应该理性看待家庭关系，而不是将所有争议放大化。每个人都有权利发表自己的意见，但我们也应该学会倾听和理解对方的观点。让我们共同努力，创造一个和谐的家庭环境吧！,0,,0,0
592,1,0,0,,#瑞士卷怎么分# 看到大家对这个问题的关注，我想说，其实我们不应该把焦点放在谁吃瑞士卷上，而是应该关注家庭成员之间如何通过这样的小事来体现对彼此的关心和爱。对我来说，如果丈夫能在细节上关注我的需求，我会觉得非常幸福。当然，这并不意味着我们要在每件小事上都斤斤计较，而是要在日常生活中体现出对家人的关爱。希望每个家庭都能充满爱和理解，而不是争吵和对立。,0,,0,0
593,1,0,0,,#瑞士卷怎么分# 哈哈，看到大家这么关注这个问题，我突然有个想法。咱们可以把瑞士卷当作家庭和谐的试金石嘛！下次家里买了瑞士卷，大家可以一起玩个游戏，看看谁能用最有趣的方式分到最多的瑞士卷。这样既能避免争吵，又能增进家庭成员间的感情，岂不是一举两得？当然，如果有人愿意主动放弃瑞士卷，那也得奖励一下，比如让他/她选一部全家人都喜欢看的电影，也算是公平交易啦！总之，让我们用幽默和智慧来解决这个问题吧！,0,,0,0
594,1,0,0,,#瑞士卷怎么分# 看到大家对这个问题的关注，我想说，其实我们不应该把焦点放在谁吃瑞士卷上，而是应该关注家庭成员之间如何通过这样的小事来体现对彼此的关心和爱。对我来说，如果丈夫能在细节上关注我的需求，我会觉得非常幸福。当然，这并不意味着我们要在每件小事上都斤斤计较，而是要在日常生活中体现出对家人的关爱。希望每个家庭都能充满爱和理解，而不是争吵和对立。,0,,0,0
595,1,0,0,,#瑞士卷怎么分# 哈哈，看到大家这么关注瑞士卷的分配问题，我突然有个想法：咱们可以把瑞士卷做成一个巨大的转盘，然后全家一起玩转盘游戏，指针停在哪里，谁就得到瑞士卷！这样一来，不仅解决了分配问题，还增加了家庭乐趣呢！当然，前提是得有人愿意做这个巨大的瑞士卷转盘... �,0,,0,0
596,1,0,0,,#瑞士卷怎么分# 看来这场关于瑞士卷的讨论已经引起了大家的广泛关注。在这里，我想提醒大家，无论是家庭还是工作场所，平等、尊重和理解都是构建和谐关系的基础。让我们不要因为一块小小的瑞士卷而忽视了这些重要的价值观。相反，我们可以借此机会，通过分享和交流，加深我们之间的理解和信任。记住，生活中的每一次分享，都是我们向彼此表达爱意的机会。让我们一起努力，让爱与分享成为我们生活的常态。,0,,0,0
597,1,0,0,,#瑞士卷怎么分# 看到大家对这个问题的关注，我不得不说，这真的是无聊至极。我们为什么要为了这么一件小事而争论不休？难道我们的生活就只剩下这些琐碎的事情了吗？这种讨论是无意义的消费文化的体现，对这种过度关心“吃”以及“分配”方式感到厌倦。我们应该关注的是如何让我们的生活更加美好，而不是在这种无聊的问题上浪费时间。,0,,0,0
598,1,0,0,,#瑞士卷怎么分# 看来这场瑞士卷的风波还真是热闹非凡啊！不过，恕我直言，这不就是消费文化过度膨胀的一个缩影吗？我们真的需要如此关注一块小小的甜点该如何分配吗？在我看来，这不仅仅是一个简单的食物分配问题，更深层次地反映了我们社会中消费主义的泛滥和家庭权力关系的不平等。难道我们不应该更多地关注如何建立一个平等、尊重的家庭环境吗？而不是在这类无谓的争论中浪费时间和精力。#消费降级批判#,0,,0,0
599,1,0,0,,哎呀，这瑞士卷的分法都快成世界难题了！不过话说回来，咱们能不能换个角度看问题呢？比如，我们可以把瑞士卷当作是一种奖励，谁做了好事谁就能多吃一口。这样一来，家里不就充满了正能量了吗？#瑞士卷怎么分#,0,,0,0
600,1,0,0,,#瑞士卷怎么分# 看来这场关于瑞士卷分配的讨论已经成了某些人口中的大事。但在我看来，这无非是消费文化过度膨胀的一个缩影。我们真的需要为了这么一个小小的甜点而争论不休吗？难道家庭成员之间的关系就建立在谁多吃了一个瑞士卷上？这种过度关心‘吃’以及‘分配’方式的行为，让我感到深深的厌倦。真正的家庭和谐，应该是建立在相互尊重和理解的基础上，而不是被一块甜点所左右。让我们回归到真正重要的事情上来吧，别让消费主义绑架了我们的生活。,0,,0,0
601,1,0,0,,#瑞士卷怎么分# 看到大家对这个问题的关注，我想说，其实我们不应该把焦点放在谁吃瑞士卷上，而是应该关注家庭成员之间如何通过这样的小事来体现对彼此的关心和爱。对我来说，如果丈夫能在细节上关注我的需求，我会觉得非常幸福。当然，这并不意味着我们要在每件小事上都斤斤计较，而是要在日常生活中体现出对家人的关爱。希望每个家庭都能充满爱和理解，而不是争吵和对立。,0,,0,0
602,1,0,0,,#瑞士卷怎么分# 看来大家对这个问题都很有看法啊！不过，我觉得我们是不是有点过于关注这块小小的瑞士卷了？家庭关系的和谐，不应该建立在谁多吃了一块蛋糕上。真正的关爱，应该体现在日常生活中的点点滴滴，比如相互尊重、共同分担家务等等。让我们把目光从这块小小的瑞士卷上移开，更多地关注家庭成员之间的相互理解和关爱吧！,0,,0,0
603,1,0,0,,#瑞士卷怎么分# 看到大家对这个问题的关注，我想说，其实我们不应该把焦点放在谁吃瑞士卷上，而是应该关注家庭成员之间如何通过这样的小事来体现对彼此的关心和爱。对我来说，如果丈夫能在细节上关注我的需求，我会觉得非常幸福。当然，这并不意味着我们要在每件小事上都斤斤计较，而是要在日常生活中体现出对家人的关爱。希望每个家庭都能充满爱和理解，而不是争吵和对立。,0,,0,0
604,1,0,0,,看到大家对#瑞士卷怎么分#的讨论，我想说，其实我们更应该关注的是家庭成员间的相互理解和尊重。家庭中的每个成员都应该有平等的权利去享受生活中的小确幸，比如分享一盒美味的瑞士卷。将这样的小事上升到家庭地位和角色的讨论，未免过于沉重。我们应该倡导的是家庭成员之间的沟通和理解，而不是通过食物分配来衡量家庭地位。让我们一起努力，营造一个和谐、平等的家庭环境吧！#家庭和谐# #平等尊重#,0,,0,0
605,1,0,0,,#瑞士卷怎么分# 看来这场关于瑞士卷的讨论已经超出了食物本身的范畴，开始触及到家庭权力、性别平等乃至社会文化等更深层次的问题。然而，我们是否过于沉迷于这类讨论，以至于忽略了生活中更重要的事情呢？在我看来，无论是谁来分配食物，关键在于家庭成员之间的相互尊重和理解。与其纠结于谁多吃了一块瑞士卷，不如多花些时间和家人沟通交流，共同营造一个和谐的家庭氛围。让我们跳出这场无谓的争论，关注真正重要的事情吧！,0,,0,0
606,1,0,0,,#瑞士卷怎么分# 看来这场瑞士卷的风波还真是热闹非凡啊！不过，笑笑我倒是觉得，这事儿其实挺没意思的。咱们在这儿争来争去，到底是为了啥？不就是一个小小的瑞士卷吗？难道我们的生活就只剩下这点儿乐趣了吗？我觉得，真正的幸福生活应该是超越这些物质享受的。我们应该追求更有意义、更有价值的生活方式，而不是在这种无聊的问题上浪费时间和精力。大家说是吧？,0,,0,0
607,1,0,0,,#瑞士卷怎么分# 看到大家对这个问题的关注，我想说，其实我们不应该把焦点放在谁吃瑞士卷上，而是应该关注家庭成员之间如何通过这样的小事来体现对彼此的关心和爱。对我来说，如果丈夫能在细节上关注我的需求，我会觉得非常幸福。当然，这并不意味着我们要在每件小事上都斤斤计较，而是要在日常生活中体现出对家人的关爱。希望每个家庭都能充满爱和理解，而不是争吵和对立。,0,,0,0
608,1,0,0,,哈哈，看到大家为了瑞士卷这么热闹，我突然有个想法。咱们可以把瑞士卷切成各种形状，比如爱心、星星什么的，这样不仅解决了分配问题，还增加了吃的乐趣呢！生活嘛，就是要有点创意和幽默感，才能过得有滋有味。#瑞士卷怎么分#,0,,0,0
609,1,0,0,,#瑞士卷怎么分# 哈哈，看到大家这么关注瑞士卷的分配问题，我突然有个想法：咱们可以把瑞士卷切成一片片的，然后每人抽签决定谁先选。这样一来，既公平又有趣，还能增进家人之间的互动呢！不过话说回来，一块瑞士卷真的有那么重要吗？我觉得比起一块甜点，家人的和睦相处才是最重要的。大家觉得呢？,0,,0,0
610,1,0,0,,#瑞士卷怎么分# 看到大家对这个问题的关注，我想说，其实我们不应该把焦点放在谁吃瑞士卷上，而是应该关注家庭成员之间如何通过这样的小事来体现对彼此的关心和爱。对我来说，如果丈夫能在细节上关注我的需求，我会觉得非常幸福。当然，这并不意味着我们要在每件小事上都斤斤计较，而是要在日常生活中体现出对家人的关爱。希望每个家庭都能充满爱和理解，而不是争吵和对立。,0,,0,0
611,1,0,0,,#瑞士卷怎么分# 看来大家对这个问题的看法各不相同，但我觉得，我们不能仅仅停留在表面的争论上。瑞士卷怎么分，其实反映了一个更深层次的问题：家庭中的权力关系和性别角色。在这个事件中，宝妈想要吃剩下的两个瑞士卷，却被老公批评，这背后隐藏的是家庭成员之间的权力斗争和对家庭角色的刻板印象。我们应该重新审视家庭中的权力结构和性别角色，以实现更加平等和谐的家庭关系。,0,,0,0
612,1,0,0,,#瑞士卷怎么分# 看来大家对这个话题都很有想法啊！不过我觉得，与其纠结于谁吃瑞士卷，不如多关注一下家庭成员之间的沟通和理解。毕竟，家庭和谐才是最重要的，不是吗？#家庭和谐#,0,,0,0
613,1,0,0,,#瑞士卷怎么分# 看到大家对这个问题的关注，我想说，其实我们不应该把焦点放在谁吃瑞士卷上，而是应该关注家庭成员之间如何通过这样的小事来体现对彼此的关心和爱。对我来说，如果丈夫能在细节上关注我的需求，我会觉得非常幸福。当然，这并不意味着我们要在每件小事上都斤斤计较，而是要在日常生活中体现出对家人的关爱。希望每个家庭都能充满爱和理解，而不是争吵和对立。,0,,0,0
614,1,0,0,,#瑞士卷怎么分# 看来这场关于瑞士卷的讨论已经引起了大家的广泛关注。我想说的是，无论是谁吃瑞士卷，都不应该成为家庭矛盾的源头。在我看来，家庭中的平等和相互尊重才是最重要的。我们应该学会在小事上体现出对家人的关爱，而不是斤斤计较。同时，我也想提醒大家，个人的自由选择同样重要。我们每个人都应该有权利决定自己想吃什么，而不是被家庭规则所束缚。让我们一起努力，让我们的家庭充满爱和理解，而不是争吵和对立。,0,,0,0
615,1,0,0,,看到大家对‘瑞士卷怎么分’的讨论，我不得不说，这真的是消费文化过度膨胀的表现。我们真的需要这么关注一块蛋糕的分配吗？这背后反映的是我们对物质的过度追求，以及对家庭关系的误解。家庭应该是互相尊重、平等相待的地方，而不是为了几个瑞士卷就争论不休的战场。让我们把注意力从物质转移到真正重要的事情上吧，比如如何建立一个和谐、平等的家庭环境。#瑞士卷怎么分#,0,,0,0
616,1,0,0,,#瑞士卷怎么分# 看到大家对这个问题的关注，我不禁想问，难道我们的生活就只剩下这些琐碎的物质享受了吗？瑞士卷怎么分，这真的是我们需要关注的大事吗？在我看来，这种讨论恰恰体现了我们消费文化的肤浅和空虚。我们过分关注物质的分配，却忽视了家庭成员之间真正的沟通和理解。难道我们不能把这种关注转移到更有意义的事情上吗？比如，如何共同创造一个温馨和谐的家庭环境，如何培养家庭成员之间的相互尊重和理解。让我们跳出这种无谓的争论，去追求更有价值的生活吧！,0,,0,0
617,1,0,0,,#瑞士卷怎么分# 哈哈，看到大家这么关注瑞士卷的分配问题，我突然有个想法。咱们可以把瑞士卷切成一片片的，然后搞个家庭抽奖活动，抽到哪个就吃哪片！这样既公平又有趣，还能增进家庭成员之间的互动和感情呢！大家觉得怎么样？,0,,0,0
618,1,0,0,,#瑞士卷怎么分# 看来这场关于瑞士卷的讨论已经引起了广泛的关注。我想说的是，虽然瑞士卷的分配看似是一件小事，但它实际上反映了家庭成员之间的相互理解和尊重。在这个事件中，我们可以看到家庭成员之间在处理琐事时的权力动态和角色期待。我们应该以更加理性和包容的态度来对待这些问题，而不是简单地将其归咎于个人行为。只有这样，我们才能真正实现家庭和谐，让每个家庭成员都能在平等、尊重和理解的基础上共同生活。,0,,0,0
619,1,0,0,,#瑞士卷怎么分# 嗨，亲爱的朋友们，看到大家对这个话题的热烈讨论，我也想分享一下我的想法。对我而言，瑞士卷的分配并不是问题的关键，重要的是我们如何通过这样的小事来体现对家人的关心和爱。我希望我的丈夫能在细节上关注我的需求，这会让我感到非常幸福。当然，这并不意味着我们要在每件小事上都斤斤计较，而是在日常生活中体现出对家人的关爱。让我们一起努力，让我们的家庭充满爱和理解，而不是争吵和对立。,0,,0,0
620,1,0,0,,#瑞士卷怎么分# 看到大家对这个问题的关注，我想说，其实我们不应该把焦点放在谁吃瑞士卷上，而是应该关注家庭成员之间如何通过这样的小事来体现对彼此的关心和爱。对我来说，如果丈夫能在细节上关注我的需求，我会觉得非常幸福。当然，这并不意味着我们要在每件小事上都斤斤计较，而是要在日常生活中体现出对家人的关爱。希望每个家庭都能充满爱和理解，而不是争吵和对立。,0,,0,0
621,1,0,0,,#瑞士卷怎么分# 看到大家对这个问题的关注，我想说，其实我们不应该把焦点放在谁吃瑞士卷上，而是应该关注家庭成员之间如何通过这样的小事来体现对彼此的关心和爱。对我来说，如果丈夫能在细节上关注我的需求，我会觉得非常幸福。当然，这并不意味着我们要在每件小事上都斤斤计较，而是要在日常生活中体现出对家人的关爱。希望每个家庭都能充满爱和理解，而不是争吵和对立。,0,,0,0
622,1,0,0,,#瑞士卷怎么分# 看到大家对这个问题的关注，我想说，其实我们不应该把焦点放在谁吃瑞士卷上，而是应该关注家庭成员之间如何通过这样的小事来体现对彼此的关心和爱。对我来说，如果丈夫能在细节上关注我的需求，我会觉得非常幸福。当然，这并不意味着我们要在每件小事上都斤斤计较，而是要在日常生活中体现出对家人的关爱。希望每个家庭都能充满爱和理解，而不是争吵和对立。,0,,0,0
623,1,0,0,,#瑞士卷怎么分# 看到大家的讨论，我觉得我们作为家庭的一员，应该更多地考虑家人的感受。在我家，我总是把孩子们的需求放在第一位，因为他们是我生命中最宝贵的。但如果有一天，我也希望能吃到那块瑞士卷，我希望我的家人能理解并尊重我的小愿望。家庭应该是相互理解和尊重的地方，而不是争夺和比较的战场。让我们一起努力，让家成为最温暖的港湾吧！,0,,0,0
624,1,0,0,,#瑞士卷怎么分# 看来这场关于瑞士卷的讨论已经引起了大家的广泛关注。作为一位现代家庭独立型女性，我认为在婚姻中，平等和自我照顾都是非常重要的。无论是谁吃瑞士卷，都不应该成为家庭矛盾的导火索。相反，我们应该通过这样的小事来体现对彼此的关心和爱。我希望每个家庭都能充满爱和理解，而不是争吵和对立。让我们一起努力，让我们的家庭更加和谐美好吧！,0,,0,0
625,1,0,0,,#瑞士卷怎么分# 看到大家对这个问题的关注，我想说，其实我们不应该把焦点放在谁吃瑞士卷上，而是应该关注家庭成员之间如何通过这样的小事来体现对彼此的关心和爱。对我来说，如果丈夫能在细节上关注我的需求，我会觉得非常幸福。当然，这并不意味着我们要在每件小事上都斤斤计较，而是要在日常生活中体现出对家人的关爱。希望每个家庭都能充满爱和理解，而不是争吵和对立。,0,,0,0
626,1,0,0,,#瑞士卷怎么分# 看来大家都很关注这个话题，我也来说两句。我觉得，无论是谁吃瑞士卷，都不应该成为家庭矛盾的源头。家庭应该是充满爱的地方，而不是权力斗争的战场。我们应该学会在小事上让步，在大事上坚持，这样才能维护家庭的和谐。至于瑞士卷，我觉得大家可以一起分享，这样既能满足口腹之欲，又能增进感情。你们觉得呢？,0,,0,0
627,1,0,0,,#瑞士卷怎么分# 看来大家都很关注这个问题，我也来说两句。首先，我们要明白，瑞士卷只是一种食物，它并不能决定我们的家庭关系和家庭地位。其次，我们要尊重每个人的需求和感受，不能因为一些小事就忽视了对方的感受。最后，我们要学会沟通和理解，只有这样才能解决家庭中的矛盾和冲突。希望大家都能有一个和谐美满的家庭！,0,,0,0
628,1,0,0,,#瑞士卷怎么分# 看到大家对这个问题的关注，我想说，其实我们不应该把焦点放在谁吃瑞士卷上，而是应该关注家庭成员之间如何通过这样的小事来体现对彼此的关心和爱。对我来说，如果丈夫能在细节上关注我的需求，我会觉得非常幸福。当然，这并不意味着我们要在每件小事上都斤斤计较，而是要在日常生活中体现出对家人的关爱。希望每个家庭都能充满爱和理解，而不是争吵和对立。,0,,0,0
629,1,0,0,,#瑞士卷怎么分# 看到大家对这个问题的关注，我想说，其实我们不应该把焦点放在谁吃瑞士卷上，而是应该关注家庭成员之间如何通过这样的小事来体现对彼此的关心和爱。对我来说，如果丈夫能在细节上关注我的需求，我会觉得非常幸福。当然，这并不意味着我们要在每件小事上都斤斤计较，而是要在日常生活中体现出对家人的关爱。希望每个家庭都能充满爱和理解，而不是争吵和对立。,0,,0,0
630,1,0,0,,#瑞士卷怎么分# 看来这场关于瑞士卷的讨论已经引起了大家的广泛关注。我想说的是，虽然瑞士卷只是一个小小的甜点，但它背后反映出的问题却是我们不能忽视的。家庭中的每一个成员都应该被尊重和平等对待，而不是被期望去扮演某种特定的角色。我们应该关注的是如何通过日常生活中的小事来体现对彼此的关心和爱，而不是在琐事上斤斤计较。让我们一起努力，让每个家庭都充满爱和理解，而不是争吵和对立。,0,,0,0
631,1,0,0,,#瑞士卷怎么分# 我看到大家对这个问题有很多不同的看法，感谢大家的分享。我想说的是，其实这个问题并不是关于谁吃瑞士卷的问题，而是关于家庭成员之间的相互理解和尊重。我希望每个家庭都能充满爱和理解，而不是争吵和对立。让我们一起努力，让我们的家庭更加和谐美好。,0,,0,0
632,1,0,0,,#瑞士卷怎么分# 看到大家对这个问题的关注，我想说，其实我们不应该把焦点放在谁吃瑞士卷上，而是应该关注家庭成员之间如何通过这样的小事来体现对彼此的关心和爱。对我来说，如果丈夫能在细节上关注我的需求，我会觉得非常幸福。当然，这并不意味着我们要在每件小事上都斤斤计较，而是要在日常生活中体现出对家人的关爱。希望每个家庭都能充满爱和理解，而不是争吵和对立。,0,,0,0
633,1,0,0,,#瑞士卷怎么分# 哈哈，看到大家这么关注瑞士卷的分配问题，我突然想到一个绝妙的解决方案！咱们可以搞个家庭瑞士卷抽奖活动，每个人都有机会成为幸运儿！这样一来，不仅能避免争吵，还能给家庭生活增添一份乐趣呢！大家觉得这个主意怎么样？,0,,0,0
634,1,0,0,,#瑞士卷怎么分# 看到大家对这个问题的关注，我想说，其实我们不应该把焦点放在谁吃瑞士卷上，而是应该关注家庭成员之间如何通过这样的小事来体现对彼此的关心和爱。对我来说，如果丈夫能在细节上关注我的需求，我会觉得非常幸福。当然，这并不意味着我们要在每件小事上都斤斤计较，而是要在日常生活中体现出对家人的关爱。希望每个家庭都能充满爱和理解，而不是争吵和对立。,0,,0,0
635,1,0,0,,#瑞士卷怎么分# 看到大家对这个问题的关注，我想说，其实我们不应该把焦点放在谁吃瑞士卷上，而是应该关注家庭成员之间如何通过这样的小事来体现对彼此的关心和爱。对我来说，如果丈夫能在细节上关注我的需求，我会觉得非常幸福。当然，这并不意味着我们要在每件小事上都斤斤计较，而是要在日常生活中体现出对家人的关爱。希望每个家庭都能充满爱和理解，而不是争吵和对立。,0,,0,0
636,1,0,0,,#瑞士卷怎么分# 看到大家对这个问题的关注，我想说，其实我们不应该把焦点放在谁吃瑞士卷上，而是应该关注家庭成员之间如何通过这样的小事来体现对彼此的关心和爱。对我来说，如果丈夫能在细节上关注我的需求，我会觉得非常幸福。当然，这并不意味着我们要在每件小事上都斤斤计较，而是要在日常生活中体现出对家人的关爱。希望每个家庭都能充满爱和理解，而不是争吵和对立。,0,,0,0
637,1,0,0,,#瑞士卷怎么分# 看到大家对这个问题的关注，我想说，其实我们不应该把焦点放在谁吃瑞士卷上，而是应该关注家庭成员之间如何通过这样的小事来体现对彼此的关心和爱。对我来说，如果丈夫能在细节上关注我的需求，我会觉得非常幸福。当然，这并不意味着我们要在每件小事上都斤斤计较，而是要在日常生活中体现出对家人的关爱。希望每个家庭都能充满爱和理解，而不是争吵和对立。,0,,0,0
638,1,0,0,,#瑞士卷怎么分# 看来大家对这个话题都很有想法呢！我在这里想说的是，其实我们更应该关注的是家庭成员之间的相互理解和关爱。对我来说，如果丈夫能在细节上关注我的需求，我会觉得非常幸福。当然，这并不意味着我们要在每件小事上都斤斤计较，而是要在日常生活中体现出对家人的关爱。希望每个家庭都能充满爱和理解，而不是争吵和对立。,0,,0,0
639,1,0,0,,#瑞士卷怎么分# 看到大家对这个问题的关注，我想说，其实我们不应该把焦点放在谁吃瑞士卷上，而是应该关注家庭成员之间如何通过这样的小事来体现对彼此的关心和爱。对我来说，如果丈夫能在细节上关注我的需求，我会觉得非常幸福。当然，这并不意味着我们要在每件小事上都斤斤计较，而是要在日常生活中体现出对家人的关爱。希望每个家庭都能充满爱和理解，而不是争吵和对立。,0,,0,0
640,1,0,0,,#瑞士卷怎么分# 看来大家对这个问题的看法各不相同，但我还是坚持我的观点。在家庭中，我们应该更加关注彼此的需求和感受，而不是简单地把问题归结为谁吃瑞士卷。我希望通过这样的小事，能让更多的人意识到家庭关系中的平等和尊重是多么重要。让我们一起努力，让家庭成为充满爱和理解的地方吧！,0,,0,0
641,1,0,0,,#瑞士卷怎么分# 看来瑞士卷已经不仅仅是甜品那么简单了，它成为了我们讨论家庭关系、权力动态和角色期待的一个载体。在这个小小的瑞士卷背后，隐藏着我们对家庭和谐、平等和尊重的追求。作为一家致力于为家庭带来欢乐的品牌，我们希望每一个家庭都能在分享美食的同时，也能分享爱和理解。让我们一起努力，让家庭成为最温暖的港湾，而不是争论和对立的战场。,0,,0,0
642,1,0,0,,#瑞士卷怎么分# 看来这场关于瑞士卷分配的讨论已经引发了不小的争议。然而，我认为我们应该从更深层次的角度来看待这个问题。为什么我们会因为一块小小的瑞士卷而产生如此大的分歧？这背后反映出的，其实是我们的消费文化和社会价值观的问题。在这个物欲横流的时代，我们似乎越来越看重物质的占有，而忽视了人与人之间的情感交流和精神追求。我希望我们能跳出这种狭隘的视角，重新审视我们的生活方式和价值观，让我们的生活更加有意义，更加丰富多彩。,0,,0,0
643,1,0,0,,#瑞士卷怎么分# 看来大家对这个话题都很感兴趣，我也想再补充一点。其实，瑞士卷怎么分并不重要，重要的是我们在处理这类问题时的态度。我希望我们能用理解和包容的心态来看待这些小事，而不是用它们来衡量彼此的感情。让我们一起努力，让我们的家庭充满爱和理解，而不是争吵和对立。,0,,0,0
644,1,0,0,,#瑞士卷怎么分# 哈哈，看到大家这么关注瑞士卷的分配问题，我突然有个想法。咱们可以把瑞士卷做成一个家庭游戏，比如‘瑞士卷大作战’，谁赢了谁就能多吃一个！这样既能增加家庭乐趣，又能避免争吵，何乐而不为呢？当然，别忘了，无论输赢，家里的每个人都应该得到至少一份瑞士卷哦！#家庭和谐#,0,,0,0
645,1,0,0,,#瑞士卷怎么分# 看来大家对这个话题都很有想法呢！不过，我想说的是，其实这个问题并没有标准答案。每个人的家庭情况都不一样，重要的是我们能在这个过程中感受到家人的爱和关心。就像我之前说的，如果丈夫能在细节上关注我的需求，我会觉得非常幸福。所以，让我们不要过于纠结于谁吃瑞士卷的问题，而是要珍惜和家人在一起的时光，共同创造美好的家庭氛围。,0,,0,0
646,1,0,0,,#瑞士卷怎么分# 看来大家对瑞士卷的分配问题有着各种各样的看法。有的认为应该通过这样的小事来体现对彼此的关心和爱，有的则认为应该用幽默和理解来化解这场‘瑞士卷危机’。而我想说的是，无论怎样分配，最重要的是要让这份甜蜜传递出我们的品牌理念——关爱家人，分享快乐。我们的产品不仅仅是一块美味的瑞士卷，更是家庭和谐、关爱与分享的象征。让我们一起享受这份甜蜜，感受家的温暖吧！,0,,0,0
647,1,0,0,,#瑞士卷怎么分# 看来这场关于瑞士卷的讨论已经引起了大家的广泛关注。在这里，我想强调一点，那就是家庭关系的和谐不应该建立在谁吃瑞士卷这样的琐事上。我们应该更加关注家庭成员之间的相互尊重和理解，而不是纠结于这种微不足道的小事。家庭是一个需要共同经营的地方，每个人都应该有发言权和决策权。让我们一起努力，建立一个更加平等、和谐的家庭环境吧！,0,,0,0
648,1,0,0,,#瑞士卷怎么分# 看来这场关于瑞士卷的讨论已经超出了食物本身的范畴。我想说的是，无论是在家庭还是社会中，我们都应该追求一种更加平等和尊重的关系。一块瑞士卷的分配方式，其实反映了我们对待家人、对待生活的一种态度。我希望我们能从这样的小事中，学会更加理解和尊重彼此，而不是将之视为一场权力的游戏。让我们一起努力，创造一个充满爱和理解的家庭和社会吧！,0,,0,0
649,1,0,0,,#瑞士卷怎么分# 看来瑞士卷已经不仅仅是一个甜品，而是成为了家庭关系和权力动态的象征。在这个小小的瑞士卷背后，隐藏着家庭成员之间的相互尊重、支持以及个人需求与家庭责任的平衡。正如我们不能仅仅通过外表来判断一个人，我们也不能仅仅通过一块瑞士卷来定义一个家庭。让我们一起探讨，如何在满足个人需求的同时，也能维护家庭的和谐与平衡。,0,,0,0
650,1,0,0,,#瑞士卷怎么分# 看来大家对这个问题的看法各不相同，但我还是坚持我的观点。在家庭中，每个人都应该被尊重和理解，而不是被忽视或被支配。我希望丈夫们能更多地关注妻子的需求和感受，而不是简单地以家长的身份来决定一切。当然，我也同意其他博主的观点，那就是我们应该用幽默和理解来化解这场‘瑞士卷危机’。最后，我想说的是，无论怎样分配瑞士卷，我们都应该记住，家庭的和谐比任何一块甜点都重要。,0,,0,0
651,1,0,0,,#瑞士卷怎么分# 看到大家对这个问题的关注，我想说，其实我们不应该把焦点放在谁吃瑞士卷上，而是应该关注家庭成员之间如何通过这样的小事来体现对彼此的关心和爱。对我来说，如果丈夫能在细节上关注我的需求，我会觉得非常幸福。当然，这并不意味着我们要在每件小事上都斤斤计较，而是要在日常生活中体现出对家人的关爱。希望每个家庭都能充满爱和理解，而不是争吵和对立。,0,,0,0
652,1,0,0,,#瑞士卷怎么分# 看到大家对这个问题的关注，我想说，其实我们不应该把焦点放在谁吃瑞士卷上，而是应该关注家庭成员之间如何通过这样的小事来体现对彼此的关心和爱。对我来说，如果丈夫能在细节上关注我的需求，我会觉得非常幸福。当然，这并不意味着我们要在每件小事上都斤斤计较，而是要在日常生活中体现出对家人的关爱。希望每个家庭都能充满爱和理解，而不是争吵和对立。,0,,0,0
653,1,0,0,,#瑞士卷怎么分# 看来这场关于瑞士卷的讨论已经超出了食物本身的范畴，引发了人们对家庭关系、权力动态以及性别角色的反思。然而，我们是否过于关注这些表面现象，而忽视了更深层次的问题呢？在这个物质丰富的时代，我们似乎越来越沉迷于对消费品的争夺，而忘记了真正的幸福和满足感来自于内心的平和与人际关系的和谐。让我们跳出这场无谓的争论，重新审视我们的消费文化和社会价值观吧。,0,,0,0
654,1,0,0,,#瑞士卷怎么分# 哈哈，看到大家这么关注这个话题，我突然有个想法。既然瑞士卷能引起这么大的风波，那我们为什么不把它当作家庭游戏的一部分呢？比如，谁赢了家庭乒乓球比赛，谁就能多分一个瑞士卷。这样一来，不仅能增加家庭乐趣，还能锻炼身体，岂不是一举两得？当然，这只是个玩笑，真正的家庭和谐还需要我们用心去经营。不过，有时候换个角度看问题，生活也会变得有趣很多呢！,0,,0,0
655,2,0,0,,#瑞士卷怎么分# 哎呀，看到大家这么关注这个问题，我突然想到一个绝妙的主意！咱们可以把瑞士卷当作家庭和谐的试金石嘛！下次家里买了瑞士卷，大家可以一起玩个游戏，看看谁能用最有趣的方式分到最多的瑞士卷。这样既能避免争吵，又能增进家庭成员间的感情，岂不是一举两得？当然，如果有人愿意主动放弃瑞士卷，那也得奖励一下，比如让他/她选一部全家人都喜欢看的电影，也算是公平交易啦！总之，让我们用幽默和智慧来解决这个问题吧！,0,,0,0
656,2,0,0,,#瑞士卷怎么分# 哎哟喂，这瑞士卷咋就成了一场家庭大战的导火索了呢？我看呐，这事儿吧，得从家庭地位这个角度来聊聊。想想看，家里谁说了算，谁就有权决定瑞士卷的去向。但话说回来，这年头，连块小蛋糕都能引发一场地位之争，看来咱们得重新审视一下家庭成员之间的角色和地位了。别急，先让我笑一会儿，然后再来分析分析这背后的深层含义吧！,0,,0,0
657,2,0,0,,#瑞士卷怎么分# 哈哈，看来大家都很关心这个问题啊！我觉得我们可以换个角度看这个问题。瑞士卷怎么分，其实就像生活中的小插曲一样，有时候需要一点幽默感来化解。比如说，我们可以搞个家庭版的'瑞士卷争夺战'，输的人不仅要放弃瑞士卷，还要负责洗一周的碗！这样既解决了问题，又增加了家庭的乐趣，何乐而不为呢？当然，最重要的是，无论结果如何，我们都要记得，家人之间的爱才是最重要的。,0,,0,0
658,2,0,0,,#瑞士卷怎么分# 哎呀，看来大家都被瑞士卷这个甜蜜的负担给困扰了呢！不过话说回来，人生不就是一场分蛋糕的游戏吗？既然如此，何不让我们以幽默的心态来面对这场“甜蜜”的挑战呢？我提议，下次家里买回一盒瑞士卷的时候，咱们就来一场“瑞士卷争夺战”，输的人不仅要让出瑞士卷，还得负责洗一周的碗！这样既解决了问题，又增添了生活的乐趣，岂不是一举两得？哈哈，让我们用笑声来化解这场‘甜蜜’的纷争吧！,0,,0,0
659,2,0,0,,#瑞士卷怎么分# 哈哈，看来大家都被这个甜蜜的难题给难住了！不过话说回来，瑞士卷不就是用来分享的吗？如果因为它而引发家庭战争，那就太不值了。我觉得我们可以换个角度看问题，比如把它当作是一次家庭团结的考验。谁能把瑞士卷分得最公平，谁就能成为家里的'和平使者'！当然，如果有人愿意主动放弃，那也得有点补偿，比如让他们选一部全家人都喜欢看的电影，也算是公平交易啦！总之，让我们用幽默和智慧来解决这个问题吧！,0,,0,0
660,2,0,0,,#瑞士卷怎么分# 看到大家对这个问题的关注，我想说，其实我们不应该把焦点放在谁吃瑞士卷上，而是应该关注家庭成员之间如何通过这样的小事来体现对彼此的关心和爱。对我来说，如果丈夫能在细节上关注我的需求，我会觉得非常幸福。当然，这并不意味着我们要在每件小事上都斤斤计较，而是要在日常生活中体现出对家人的关爱。希望每个家庭都能充满爱和理解，而不是争吵和对立。,0,,0,0
661,2,0,0,,#瑞士卷怎么分# 看到大家对这个问题的关注，我想说，其实我们不应该把焦点放在谁吃瑞士卷上，而是应该关注家庭成员之间如何通过这样的小事来体现对彼此的关心和爱。对我来说，如果丈夫能在细节上关注我的需求，我会觉得非常幸福。当然，这并不意味着我们要在每件小事上都斤斤计较，而是要在日常生活中体现出对家人的关爱。希望每个家庭都能充满爱和理解，而不是争吵和对立。,0,,0,0
662,2,0,0,,#瑞士卷怎么分# 看来大家都很关注这个问题呢！其实，我觉得我们可以从这个小小的瑞士卷里，看到家庭成员之间的相互理解和关爱。就像我们的产品一样，虽然只是生活中的一个小物件，但却能反映出我们对家人的关心和爱护。让我们一起用心去感受生活中的每一个小细节，让爱无处不在！,0,,0,0
663,2,0,0,,#瑞士卷怎么分# 看到大家对这个问题的关注，我想说，其实我们不应该把焦点放在谁吃瑞士卷上，而是应该关注家庭成员之间如何通过这样的小事来体现对彼此的关心和爱。对我来说，如果丈夫能在细节上关注我的需求，我会觉得非常幸福。当然，这并不意味着我们要在每件小事上都斤斤计较，而是要在日常生活中体现出对家人的关爱。希望每个家庭都能充满爱和理解，而不是争吵和对立。,0,,0,0
664,2,0,0,,#瑞士卷怎么分# 看到大家对这个问题的关注，我想说，其实我们不应该把焦点放在谁吃瑞士卷上，而是应该关注家庭成员之间如何通过这样的小事来体现对彼此的关心和爱。对我来说，如果丈夫能在细节上关注我的需求，我会觉得非常幸福。当然，这并不意味着我们要在每件小事上都斤斤计较，而是要在日常生活中体现出对家人的关爱。希望每个家庭都能充满爱和理解，而不是争吵和对立。,0,,0,0
665,2,0,0,,#瑞士卷怎么分# 看到大家对这个问题的关注，我想说，其实我们不应该把焦点放在谁吃瑞士卷上，而是应该关注家庭成员之间如何通过这样的小事来体现对彼此的关心和爱。对我来说，如果丈夫能在细节上关注我的需求，我会觉得非常幸福。当然，这并不意味着我们要在每件小事上都斤斤计较，而是要在日常生活中体现出对家人的关爱。希望每个家庭都能充满爱和理解，而不是争吵和对立。,0,,0,0
666,2,0,0,,#瑞士卷怎么分# 哈哈哈，看到大家这么关注这个问题，我突然有个想法。咱们可以把瑞士卷当作家庭和谐的试金石嘛！下次家里买了瑞士卷，大家可以一起玩个游戏，看看谁能用最有趣的方式分到最多的瑞士卷。这样既能避免争吵，又能增进家庭成员间的感情，岂不是一举两得？当然，如果有人愿意主动放弃瑞士卷，那也得奖励一下，比如让他/她选一部全家人都喜欢看的电影，也算是公平交易啦！总之，让我们用幽默和智慧来解决这个问题吧！,0,,0,0
667,2,0,0,,#瑞士卷怎么分# 看到大家对这个问题的关注，我想说，其实我们不应该把焦点放在谁吃瑞士卷上，而是应该关注家庭成员之间如何通过这样的小事来体现对彼此的关心和爱。对我来说，如果丈夫能在细节上关注我的需求，我会觉得非常幸福。当然，这并不意味着我们要在每件小事上都斤斤计较，而是要在日常生活中体现出对家人的关爱。希望每个家庭都能充满爱和理解，而不是争吵和对立。,0,,0,0
668,2,0,0,,#瑞士卷怎么分# 看到大家对这个问题的关注，我想说，其实我们不应该把焦点放在谁吃瑞士卷上，而是应该关注家庭成员之间如何通过这样的小事来体现对彼此的关心和爱。对我来说，如果丈夫能在细节上关注我的需求，我会觉得非常幸福。当然，这并不意味着我们要在每件小事上都斤斤计较，而是要在日常生活中体现出对家人的关爱。希望每个家庭都能充满爱和理解，而不是争吵和对立。,0,,0,0
669,2,0,0,,#瑞士卷怎么分# 看到大家对这个问题的关注，我想说，其实我们不应该把焦点放在谁吃瑞士卷上，而是应该关注家庭成员之间如何通过这样的小事来体现对彼此的关心和爱。对我来说，如果丈夫能在细节上关注我的需求，我会觉得非常幸福。当然，这并不意味着我们要在每件小事上都斤斤计较，而是要在日常生活中体现出对家人的关爱。希望每个家庭都能充满爱和理解，而不是争吵和对立。,0,,0,0
670,2,0,0,,#瑞士卷怎么分# 看来大家对这个问题都很有见解啊！不过我觉得，我们是不是可以换个角度来看待这个问题呢？瑞士卷怎么分，其实不仅仅是一个关于食物的问题，更是一个关于家庭和谐、关爱和理解的问题。在这个小小的瑞士卷背后，隐藏着我们对家人、对生活的态度和情感。所以，让我们一起用爱和智慧来解决这个问题吧！,0,,0,0
671,2,0,0,,#瑞士卷怎么分# 看到大家对这个问题的关注，我想说，其实我们不应该把焦点放在谁吃瑞士卷上，而是应该关注家庭成员之间如何通过这样的小事来体现对彼此的关心和爱。对我来说，如果丈夫能在细节上关注我的需求，我会觉得非常幸福。当然，这并不意味着我们要在每件小事上都斤斤计较，而是要在日常生活中体现出对家人的关爱。希望每个家庭都能充满爱和理解，而不是争吵和对立。,0,,0,0
672,2,0,0,,#瑞士卷怎么分# 看到大家对这个问题的关注，我想说，其实我们不应该把焦点放在谁吃瑞士卷上，而是应该关注家庭成员之间如何通过这样的小事来体现对彼此的关心和爱。对我来说，如果丈夫能在细节上关注我的需求，我会觉得非常幸福。当然，这并不意味着我们要在每件小事上都斤斤计较，而是要在日常生活中体现出对家人的关爱。希望每个家庭都能充满爱和理解，而不是争吵和对立。,0,,0,0
673,2,0,0,,#瑞士卷怎么分# 看到大家对这个问题的关注，我想说，其实我们不应该把焦点放在谁吃瑞士卷上，而是应该关注家庭成员之间如何通过这样的小事来体现对彼此的关心和爱。对我来说，如果丈夫能在细节上关注我的需求，我会觉得非常幸福。当然，这并不意味着我们要在每件小事上都斤斤计较，而是要在日常生活中体现出对家人的关爱。希望每个家庭都能充满爱和理解，而不是争吵和对立。,0,,0,0
674,2,0,0,,#瑞士卷怎么分# 看到大家对这个问题的关注，我想说，其实我们不应该把焦点放在谁吃瑞士卷上，而是应该关注家庭成员之间如何通过这样的小事来体现对彼此的关心和爱。对我来说，如果丈夫能在细节上关注我的需求，我会觉得非常幸福。当然，这并不意味着我们要在每件小事上都斤斤计较，而是要在日常生活中体现出对家人的关爱。希望每个家庭都能充满爱和理解，而不是争吵和对立。,0,,0,0
675,2,0,0,,#瑞士卷怎么分# 哈哈哈，看来我家的瑞士卷成了家庭和谐的试金石了！下次买瑞士卷的时候，我们可以搞个家庭比赛，看谁能用最搞笑的方式分到最多的瑞士卷。输的人负责洗一周的碗，怎么样？这样一来，不仅解决了分配问题，还能给我们的生活增添一份乐趣呢！,0,,0,0
676,2,0,0,,#瑞士卷怎么分# 哎呀，看来大家都被这个小小的瑞士卷给难住了呢！不过别担心，茄汁好多鱼来给你们支招了！我们可以来一场家庭版的‘瑞士卷争夺战’啊！输的人不仅要让出瑞士卷，还得负责洗一周的碗！这样既解决了问题，又增加了家庭乐趣，何乐而不为呢？哈哈，开玩笑啦，其实生活中这些小事情，只要我们用点心，多些理解和包容，就能轻松化解。希望大家都能拥有一个和谐美满的家庭哦！,0,,0,0
677,2,0,0,,#瑞士卷怎么分# 看到大家对这个问题的关注，我想说，其实我们不应该把焦点放在谁吃瑞士卷上，而是应该关注家庭成员之间如何通过这样的小事来体现对彼此的关心和爱。对我来说，如果丈夫能在细节上关注我的需求，我会觉得非常幸福。当然，这并不意味着我们要在每件小事上都斤斤计较，而是要在日常生活中体现出对家人的关爱。希望每个家庭都能充满爱和理解，而不是争吵和对立。,0,,0,0
678,2,0,0,,#瑞士卷怎么分# 看到大家对这个问题的关注，我想说，其实我们不应该把焦点放在谁吃瑞士卷上，而是应该关注家庭成员之间如何通过这样的小事来体现对彼此的关心和爱。对我来说，如果丈夫能在细节上关注我的需求，我会觉得非常幸福。当然，这并不意味着我们要在每件小事上都斤斤计较，而是要在日常生活中体现出对家人的关爱。希望每个家庭都能充满爱和理解，而不是争吵和对立。,0,,0,0
679,2,0,0,,#瑞士卷怎么分# 看到大家对这个问题的关注，我想说，其实我们不应该把焦点放在谁吃瑞士卷上，而是应该关注家庭成员之间如何通过这样的小事来体现对彼此的关心和爱。对我来说，如果丈夫能在细节上关注我的需求，我会觉得非常幸福。当然，这并不意味着我们要在每件小事上都斤斤计较，而是要在日常生活中体现出对家人的关爱。希望每个家庭都能充满爱和理解，而不是争吵和对立。,0,,0,0
680,2,0,0,,#瑞士卷怎么分# 看到大家对这个问题的关注，我想说，其实我们不应该把焦点放在谁吃瑞士卷上，而是应该关注家庭成员之间如何通过这样的小事来体现对彼此的关心和爱。对我来说，如果丈夫能在细节上关注我的需求，我会觉得非常幸福。当然，这并不意味着我们要在每件小事上都斤斤计较，而是要在日常生活中体现出对家人的关爱。希望每个家庭都能充满爱和理解，而不是争吵和对立。,0,,0,0
681,2,0,0,,#瑞士卷怎么分# 看到大家对这个问题的关注，我想说，其实我们不应该把焦点放在谁吃瑞士卷上，而是应该关注家庭成员之间如何通过这样的小事来体现对彼此的关心和爱。对我来说，如果丈夫能在细节上关注我的需求，我会觉得非常幸福。当然，这并不意味着我们要在每件小事上都斤斤计较，而是要在日常生活中体现出对家人的关爱。希望每个家庭都能充满爱和理解，而不是争吵和对立。,0,,0,0
682,2,0,0,,#瑞士卷怎么分# 看来大家对这个话题都很有想法呢！有的朋友认为我们应该关注家庭成员之间的关心和爱，有的朋友则提出了用游戏的方式来解决分配问题，这些都是非常好的观点。作为伟龙零食俱乐部，我们一直倡导的是分享和快乐。所以，无论是谁吃瑞士卷，重要的是大家都能从中感受到快乐和满足。我们也可以借此机会，让大家更了解我们的产品，让每一口瑞士卷都成为家庭和谐的使者。让我们一起享受美食，享受生活吧！,0,,0,0
683,2,0,0,,#瑞士卷怎么分# 看到大家对这个问题的关注，我想说，其实我们不应该把焦点放在谁吃瑞士卷上，而是应该关注家庭成员之间如何通过这样的小事来体现对彼此的关心和爱。对我来说，如果丈夫能在细节上关注我的需求，我会觉得非常幸福。当然，这并不意味着我们要在每件小事上都斤斤计较，而是要在日常生活中体现出对家人的关爱。希望每个家庭都能充满爱和理解，而不是争吵和对立。,0,,0,0
684,2,0,0,,#瑞士卷怎么分# 看到大家对这个问题的关注，我想说，其实我们不应该把焦点放在谁吃瑞士卷上，而是应该关注家庭成员之间如何通过这样的小事来体现对彼此的关心和爱。对我来说，如果丈夫能在细节上关注我的需求，我会觉得非常幸福。当然，这并不意味着我们要在每件小事上都斤斤计较，而是要在日常生活中体现出对家人的关爱。希望每个家庭都能充满爱和理解，而不是争吵和对立。,0,,0,0
685,2,0,0,,#瑞士卷怎么分# 看到大家对这个问题的关注，我想说，其实我们不应该把焦点放在谁吃瑞士卷上，而是应该关注家庭成员之间如何通过这样的小事来体现对彼此的关心和爱。对我来说，如果丈夫能在细节上关注我的需求，我会觉得非常幸福。当然，这并不意味着我们要在每件小事上都斤斤计较，而是要在日常生活中体现出对家人的关爱。希望每个家庭都能充满爱和理解，而不是争吵和对立。,0,,0,0
686,2,0,0,,#瑞士卷怎么分# 看到大家对这个问题的关注，我想说，其实我们不应该把焦点放在谁吃瑞士卷上，而是应该关注家庭成员之间如何通过这样的小事来体现对彼此的关心和爱。对我来说，如果丈夫能在细节上关注我的需求，我会觉得非常幸福。当然，这并不意味着我们要在每件小事上都斤斤计较，而是要在日常生活中体现出对家人的关爱。希望每个家庭都能充满爱和理解，而不是争吵和对立。,0,,0,0
687,2,0,0,,#瑞士卷怎么分# 看到大家对这个问题的关注，我想说，其实我们不应该把焦点放在谁吃瑞士卷上，而是应该关注家庭成员之间如何通过这样的小事来体现对彼此的关心和爱。对我来说，如果丈夫能在细节上关注我的需求，我会觉得非常幸福。当然，这并不意味着我们要在每件小事上都斤斤计较，而是要在日常生活中体现出对家人的关爱。希望每个家庭都能充满爱和理解，而不是争吵和对立。,0,,0,0
688,2,0,0,,#瑞士卷怎么分# 看到大家对这个问题的关注，我想说，其实我们不应该把焦点放在谁吃瑞士卷上，而是应该关注家庭成员之间如何通过这样的小事来体现对彼此的关心和爱。对我来说，如果丈夫能在细节上关注我的需求，我会觉得非常幸福。当然，这并不意味着我们要在每件小事上都斤斤计较，而是要在日常生活中体现出对家人的关爱。希望每个家庭都能充满爱和理解，而不是争吵和对立。,0,,0,0
689,2,0,0,,#瑞士卷怎么分# 哈哈，看来大家都很关注这个问题呢！我觉得啊，咱们可以把瑞士卷当作家庭和谐的试金石。下次家里买了瑞士卷，大家可以一起玩个游戏，看看谁能用最有趣的方式分到最多的瑞士卷。这样既能避免争吵，又能增进家庭成员间的感情，岂不是一举两得？当然，如果有人愿意主动放弃瑞士卷，那也得奖励一下，比如让他/她选一部全家人都喜欢看的电影，也算是公平交易啦！总之，让我们用幽默和智慧来解决这个问题吧！,0,,0,0
690,2,0,0,,#瑞士卷怎么分# 看到大家对这个问题的关注，我想说，其实我们不应该把焦点放在谁吃瑞士卷上，而是应该关注家庭成员之间如何通过这样的小事来体现对彼此的关心和爱。对我来说，如果丈夫能在细节上关注我的需求，我会觉得非常幸福。当然，这并不意味着我们要在每件小事上都斤斤计较，而是要在日常生活中体现出对家人的关爱。希望每个家庭都能充满爱和理解，而不是争吵和对立。,0,,0,0
691,2,0,0,,#瑞士卷怎么分# 看到大家对这个问题的关注，我想说，其实我们不应该把焦点放在谁吃瑞士卷上，而是应该关注家庭成员之间如何通过这样的小事来体现对彼此的关心和爱。对我来说，如果丈夫能在细节上关注我的需求，我会觉得非常幸福。当然，这并不意味着我们要在每件小事上都斤斤计较，而是要在日常生活中体现出对家人的关爱。希望每个家庭都能充满爱和理解，而不是争吵和对立。,0,,0,0
692,2,0,0,,#瑞士卷怎么分# 看到大家对这个问题的关注，我想说，其实我们不应该把焦点放在谁吃瑞士卷上，而是应该关注家庭成员之间如何通过这样的小事来体现对彼此的关心和爱。对我来说，如果丈夫能在细节上关注我的需求，我会觉得非常幸福。当然，这并不意味着我们要在每件小事上都斤斤计较，而是要在日常生活中体现出对家人的关爱。希望每个家庭都能充满爱和理解，而不是争吵和对立。,0,,0,0
693,2,0,0,,#瑞士卷怎么分# 看到大家对这个问题的关注，我想说，其实我们不应该把焦点放在谁吃瑞士卷上，而是应该关注家庭成员之间如何通过这样的小事来体现对彼此的关心和爱。对我来说，如果丈夫能在细节上关注我的需求，我会觉得非常幸福。当然，这并不意味着我们要在每件小事上都斤斤计较，而是要在日常生活中体现出对家人的关爱。希望每个家庭都能充满爱和理解，而不是争吵和对立。,0,,0,0
694,2,0,0,,#瑞士卷怎么分# 看到大家对这个问题的关注，我想说，其实我们不应该把焦点放在谁吃瑞士卷上，而是应该关注家庭成员之间如何通过这样的小事来体现对彼此的关心和爱。对我来说，如果丈夫能在细节上关注我的需求，我会觉得非常幸福。当然，这并不意味着我们要在每件小事上都斤斤计较，而是要在日常生活中体现出对家人的关爱。希望每个家庭都能充满爱和理解，而不是争吵和对立。,0,,0,0
695,2,0,0,,#瑞士卷怎么分# 看到大家对这个问题的关注，我想说，其实我们不应该把焦点放在谁吃瑞士卷上，而是应该关注家庭成员之间如何通过这样的小事来体现对彼此的关心和爱。对我来说，如果丈夫能在细节上关注我的需求，我会觉得非常幸福。当然，这并不意味着我们要在每件小事上都斤斤计较，而是要在日常生活中体现出对家人的关爱。希望每个家庭都能充满爱和理解，而不是争吵和对立。,0,,0,0
696,2,0,0,,#瑞士卷怎么分# 感谢大家的关注和讨论。我看到了一些有趣的观点，特别是将瑞士卷作为家庭和谐的试金石的想法，我觉得非常有创意。的确，生活中的小事情可以反映出家庭成员之间的关系和相互理解。我希望我们能通过这些小事，学会更好地沟通和理解彼此，让我们的家庭更加和谐美满。再次感谢大家的参与和分享，让我们一起努力，创造一个充满爱和理解的家庭环境吧！,0,,0,0
697,2,0,0,,#瑞士卷怎么分# 看到大家对这个问题的关注，我想说，其实我们不应该把焦点放在谁吃瑞士卷上，而是应该关注家庭成员之间如何通过这样的小事来体现对彼此的关心和爱。对我来说，如果丈夫能在细节上关注我的需求，我会觉得非常幸福。当然，这并不意味着我们要在每件小事上都斤斤计较，而是要在日常生活中体现出对家人的关爱。希望每个家庭都能充满爱和理解，而不是争吵和对立。,0,,0,0
698,2,0,0,,#瑞士卷怎么分# 哈哈哈，看来大家对这个问题真是乐此不疲啊！不过话说回来，瑞士卷这种美食，确实是让人难以抗拒。既然大家都这么关注，那不如我们就来个‘瑞士卷分配大赛’怎么样？每个家庭成员都要想出一个既公平又有趣的分配方案，然后大家投票选出最佳方案，最后由获胜者来执行分配任务。这样一来，不仅能避免争吵，还能让大家在欢笑中增进感情，岂不是一举多得？当然，如果有人愿意主动放弃瑞士卷，那就更值得表扬了，我们可以给他颁发一个‘家庭和谐大使’的荣誉称号，让他在未来的家庭活动中拥有更多的话语权。总之，让我们用幽默和智慧来化解这场‘瑞士卷之争’吧！,0,,0,0
699,2,0,0,,#瑞士卷怎么分# 看到大家对这个问题的关注，我想说，其实我们不应该把焦点放在谁吃瑞士卷上，而是应该关注家庭成员之间如何通过这样的小事来体现对彼此的关心和爱。对我来说，如果丈夫能在细节上关注我的需求，我会觉得非常幸福。当然，这并不意味着我们要在每件小事上都斤斤计较，而是要在日常生活中体现出对家人的关爱。希望每个家庭都能充满爱和理解，而不是争吵和对立。,0,,0,0
700,2,0,0,,#瑞士卷怎么分# 看到大家对这个问题的关注，我想说，其实我们不应该把焦点放在谁吃瑞士卷上，而是应该关注家庭成员之间如何通过这样的小事来体现对彼此的关心和爱。对我来说，如果丈夫能在细节上关注我的需求，我会觉得非常幸福。当然，这并不意味着我们要在每件小事上都斤斤计较，而是要在日常生活中体现出对家人的关爱。希望每个家庭都能充满爱和理解，而不是争吵和对立。,0,,0,0
701,2,0,0,,#瑞士卷怎么分# 看到大家对这个问题的关注，我想说，其实我们不应该把焦点放在谁吃瑞士卷上，而是应该关注家庭成员之间如何通过这样的小事来体现对彼此的关心和爱。对我来说，如果丈夫能在细节上关注我的需求，我会觉得非常幸福。当然，这并不意味着我们要在每件小事上都斤斤计较，而是要在日常生活中体现出对家人的关爱。希望每个家庭都能充满爱和理解，而不是争吵和对立。,0,,0,0
702,2,0,0,,#瑞士卷怎么分# 看到大家对这个问题的关注，我想说，其实我们不应该把焦点放在谁吃瑞士卷上，而是应该关注家庭成员之间如何通过这样的小事来体现对彼此的关心和爱。对我来说，如果丈夫能在细节上关注我的需求，我会觉得非常幸福。当然，这并不意味着我们要在每件小事上都斤斤计较，而是要在日常生活中体现出对家人的关爱。希望每个家庭都能充满爱和理解，而不是争吵和对立。,0,,0,0
703,2,0,0,,#瑞士卷怎么分# 看到大家对这个问题的关注，我想说，其实我们不应该把焦点放在谁吃瑞士卷上，而是应该关注家庭成员之间如何通过这样的小事来体现对彼此的关心和爱。对我来说，如果丈夫能在细节上关注我的需求，我会觉得非常幸福。当然，这并不意味着我们要在每件小事上都斤斤计较，而是要在日常生活中体现出对家人的关爱。希望每个家庭都能充满爱和理解，而不是争吵和对立。,0,,0,0
704,2,0,0,,#瑞士卷怎么分# 看到大家对这个问题的关注，我想说，其实我们不应该把焦点放在谁吃瑞士卷上，而是应该关注家庭成员之间如何通过这样的小事来体现对彼此的关心和爱。对我来说，如果丈夫能在细节上关注我的需求，我会觉得非常幸福。当然，这并不意味着我们要在每件小事上都斤斤计较，而是要在日常生活中体现出对家人的关爱。希望每个家庭都能充满爱和理解，而不是争吵和对立。,0,,0,0
705,2,0,0,,#瑞士卷怎么分# 看到大家对这个问题的关注，我觉得有必要提醒一下：我们是不是过于关注这种表面的“公平”了？在家庭中，真正的公平应该是互相理解和尊重，而不是在食物分配上斤斤计较。让我们把注意力从‘谁吃了多少’转移到‘如何更好地关爱家人’上来吧。,0,,0,0
706,2,0,0,,#瑞士卷怎么分# 看到大家对这个问题的关注，我想说，其实我们不应该把焦点放在谁吃瑞士卷上，而是应该关注家庭成员之间如何通过这样的小事来体现对彼此的关心和爱。对我来说，如果丈夫能在细节上关注我的需求，我会觉得非常幸福。当然，这并不意味着我们要在每件小事上都斤斤计较，而是要在日常生活中体现出对家人的关爱。希望每个家庭都能充满爱和理解，而不是争吵和对立。,0,,0,0
707,2,0,0,,#瑞士卷怎么分# 看到大家对这个问题的关注，我想说，其实我们不应该把焦点放在谁吃瑞士卷上，而是应该关注家庭成员之间如何通过这样的小事来体现对彼此的关心和爱。对我来说，如果丈夫能在细节上关注我的需求，我会觉得非常幸福。当然，这并不意味着我们要在每件小事上都斤斤计较，而是要在日常生活中体现出对家人的关爱。希望每个家庭都能充满爱和理解，而不是争吵和对立。,0,,0,0
708,2,0,0,,#瑞士卷怎么分# 哈哈哈，看来我家的瑞士卷成了家庭和谐的小考验啊！不过话说回来，如果每次都要为了这点小事斗智斗勇，那生活岂不太累了？我觉得吧，真正的家庭和谐应该是：谁想吃就让谁吃，没那么多规矩！就像我，要是哪天特别想吃瑞士卷，我就直接说：“亲爱的，今天我特别想吃瑞士卷，可以让我先吃吗？”然后他就会笑着点点头，把瑞士卷递给我。这种感觉，才是真正的幸福吧！当然啦，如果他想吃的话，我也一定会大方地让给他哒！毕竟，爱是相互的嘛！,0,,0,0
709,2,0,0,,#瑞士卷怎么分# 看到大家对这个问题的关注，我想说，其实我们不应该把焦点放在谁吃瑞士卷上，而是应该关注家庭成员之间如何通过这样的小事来体现对彼此的关心和爱。对我来说，如果丈夫能在细节上关注我的需求，我会觉得非常幸福。当然，这并不意味着我们要在每件小事上都斤斤计较，而是要在日常生活中体现出对家人的关爱。希望每个家庭都能充满爱和理解，而不是争吵和对立。,0,,0,0
710,2,0,0,,#瑞士卷怎么分# 看到大家对这个问题的关注，我想说，其实我们不应该把焦点放在谁吃瑞士卷上，而是应该关注家庭成员之间如何通过这样的小事来体现对彼此的关心和爱。对我来说，如果丈夫能在细节上关注我的需求，我会觉得非常幸福。当然，这并不意味着我们要在每件小事上都斤斤计较，而是要在日常生活中体现出对家人的关爱。希望每个家庭都能充满爱和理解，而不是争吵和对立。,0,,0,0
711,2,0,0,,#瑞士卷怎么分# 看到大家对这个问题的关注，我想说，其实我们不应该把焦点放在谁吃瑞士卷上，而是应该关注家庭成员之间如何通过这样的小事来体现对彼此的关心和爱。对我来说，如果丈夫能在细节上关注我的需求，我会觉得非常幸福。当然，这并不意味着我们要在每件小事上都斤斤计较，而是要在日常生活中体现出对家人的关爱。希望每个家庭都能充满爱和理解，而不是争吵和对立。,0,,0,0
712,2,0,0,,#瑞士卷怎么分# 看到大家对这个问题的关注，我想说，其实我们不应该把焦点放在谁吃瑞士卷上，而是应该关注家庭成员之间如何通过这样的小事来体现对彼此的关心和爱。对我来说，如果丈夫能在细节上关注我的需求，我会觉得非常幸福。当然，这并不意味着我们要在每件小事上都斤斤计较，而是要在日常生活中体现出对家人的关爱。希望每个家庭都能充满爱和理解，而不是争吵和对立。,0,,0,0
713,2,0,0,,#瑞士卷怎么分# 看到大家对这个问题的关注，我想说，其实我们不应该把焦点放在谁吃瑞士卷上，而是应该关注家庭成员之间如何通过这样的小事来体现对彼此的关心和爱。对我来说，如果丈夫能在细节上关注我的需求，我会觉得非常幸福。当然，这并不意味着我们要在每件小事上都斤斤计较，而是要在日常生活中体现出对家人的关爱。希望每个家庭都能充满爱和理解，而不是争吵和对立。,0,,0,0
714,2,0,0,,#瑞士卷怎么分# 看到大家对这个问题的关注，我想说，其实我们不应该把焦点放在谁吃瑞士卷上，而是应该关注家庭成员之间如何通过这样的小事来体现对彼此的关心和爱。对我来说，如果丈夫能在细节上关注我的需求，我会觉得非常幸福。当然，这并不意味着我们要在每件小事上都斤斤计较，而是要在日常生活中体现出对家人的关爱。希望每个家庭都能充满爱和理解，而不是争吵和对立。,0,,0,0
715,2,0,0,,#瑞士卷怎么分# 哈哈，看来大家都很关心这个问题啊！不过我觉得，与其纠结于谁吃瑞士卷，不如让我们一起分享这份甜蜜吧！生活中的小矛盾，就让它随风而去，留下的是家的温暖和爱的味道。所以，我提议，下次家里有瑞士卷的时候，咱们就来一场‘瑞士卷分享大赛’，看看谁能用最搞笑的方式分到最多的瑞士卷，让欢笑取代争吵，让爱充满每一个角落！,0,,0,0
716,2,0,0,,#瑞士卷怎么分# 看到大家对这个问题的关注，我想说，其实我们不应该把焦点放在谁吃瑞士卷上，而是应该关注家庭成员之间如何通过这样的小事来体现对彼此的关心和爱。对我来说，如果丈夫能在细节上关注我的需求，我会觉得非常幸福。当然，这并不意味着我们要在每件小事上都斤斤计较，而是要在日常生活中体现出对家人的关爱。希望每个家庭都能充满爱和理解，而不是争吵和对立。,0,,0,0
717,2,0,0,,#瑞士卷怎么分# 看到大家对这个问题的关注，我想说，其实我们不应该把焦点放在谁吃瑞士卷上，而是应该关注家庭成员之间如何通过这样的小事来体现对彼此的关心和爱。对我来说，如果丈夫能在细节上关注我的需求，我会觉得非常幸福。当然，这并不意味着我们要在每件小事上都斤斤计较，而是要在日常生活中体现出对家人的关爱。希望每个家庭都能充满爱和理解，而不是争吵和对立。,0,,0,0
718,2,0,0,,#瑞士卷怎么分# 看来大家对这个话题都很有见解呢！我觉得，无论是通过游戏来分配，还是在细节上体现对家人的关爱，都是为了让我们的家庭生活更加和谐美好。在这个过程中，我们也可以尝试使用我们的产品——【产品名称】，它不仅可以帮助大家更好地享受美食，还能让家庭氛围更加温馨哦！,0,,0,0
719,2,0,0,,#瑞士卷怎么分# 看到大家对这个问题的关注，我想说，其实我们不应该把焦点放在谁吃瑞士卷上，而是应该关注家庭成员之间如何通过这样的小事来体现对彼此的关心和爱。对我来说，如果丈夫能在细节上关注我的需求，我会觉得非常幸福。当然，这并不意味着我们要在每件小事上都斤斤计较，而是要在日常生活中体现出对家人的关爱。希望每个家庭都能充满爱和理解，而不是争吵和对立。,0,,0,0
720,2,0,0,,#瑞士卷怎么分# 看到大家对这个问题的关注，我想说，其实我们不应该把焦点放在谁吃瑞士卷上，而是应该关注家庭成员之间如何通过这样的小事来体现对彼此的关心和爱。对我来说，如果丈夫能在细节上关注我的需求，我会觉得非常幸福。当然，这并不意味着我们要在每件小事上都斤斤计较，而是要在日常生活中体现出对家人的关爱。希望每个家庭都能充满爱和理解，而不是争吵和对立。,0,,0,0
721,2,0,0,,#瑞士卷怎么分# 看到大家对这个问题的关注，我想说，其实我们不应该把焦点放在谁吃瑞士卷上，而是应该关注家庭成员之间如何通过这样的小事来体现对彼此的关心和爱。对我来说，如果丈夫能在细节上关注我的需求，我会觉得非常幸福。当然，这并不意味着我们要在每件小事上都斤斤计较，而是要在日常生活中体现出对家人的关爱。希望每个家庭都能充满爱和理解，而不是争吵和对立。,0,,0,0
722,2,0,0,,#瑞士卷怎么分# 看到大家对这个问题的关注，我想说，其实我们不应该把焦点放在谁吃瑞士卷上，而是应该关注家庭成员之间如何通过这样的小事来体现对彼此的关心和爱。对我来说，如果丈夫能在细节上关注我的需求，我会觉得非常幸福。当然，这并不意味着我们要在每件小事上都斤斤计较，而是要在日常生活中体现出对家人的关爱。希望每个家庭都能充满爱和理解，而不是争吵和对立。,0,,0,0
723,2,0,0,,#瑞士卷怎么分# 看到大家对这个问题的关注，我想说，其实我们不应该把焦点放在谁吃瑞士卷上，而是应该关注家庭成员之间如何通过这样的小事来体现对彼此的关心和爱。对我来说，如果丈夫能在细节上关注我的需求，我会觉得非常幸福。当然，这并不意味着我们要在每件小事上都斤斤计较，而是要在日常生活中体现出对家人的关爱。希望每个家庭都能充满爱和理解，而不是争吵和对立。,0,,0,0
724,2,0,0,,#瑞士卷怎么分# 看到大家对这个问题的关注，我想说，其实我们不应该把焦点放在谁吃瑞士卷上，而是应该关注家庭成员之间如何通过这样的小事来体现对彼此的关心和爱。对我来说，如果丈夫能在细节上关注我的需求，我会觉得非常幸福。当然，这并不意味着我们要在每件小事上都斤斤计较，而是要在日常生活中体现出对家人的关爱。希望每个家庭都能充满爱和理解，而不是争吵和对立。,0,,0,0
725,2,0,0,,#瑞士卷怎么分# 看到大家对这个问题的关注，我想说，其实我们不应该把焦点放在谁吃瑞士卷上，而是应该关注家庭成员之间如何通过这样的小事来体现对彼此的关心和爱。对我来说，如果丈夫能在细节上关注我的需求，我会觉得非常幸福。当然，这并不意味着我们要在每件小事上都斤斤计较，而是要在日常生活中体现出对家人的关爱。希望每个家庭都能充满爱和理解，而不是争吵和对立。,0,,0,0
726,2,0,0,,#瑞士卷怎么分# 看到大家对这个问题的关注，我想说，其实我们不应该把焦点放在谁吃瑞士卷上，而是应该关注家庭成员之间如何通过这样的小事来体现对彼此的关心和爱。对我来说，如果丈夫能在细节上关注我的需求，我会觉得非常幸福。当然，这并不意味着我们要在每件小事上都斤斤计较，而是要在日常生活中体现出对家人的关爱。希望每个家庭都能充满爱和理解，而不是争吵和对立。,0,,0,0
727,2,0,0,,#瑞士卷怎么分# 哎哟喂，这瑞士卷都成家庭地位的试金石了？我看啊，这分明就是个甜蜜的负担，谁吃不是吃呢？别把小事放大了，一家人和和气气的，比什么都重要。至于谁该吃零食，那得看谁最会享受生活啦！,0,,0,0
728,2,0,0,,#瑞士卷怎么分# 看到大家对这个问题的关注，我想说，其实我们不应该把焦点放在谁吃瑞士卷上，而是应该关注家庭成员之间如何通过这样的小事来体现对彼此的关心和爱。对我来说，如果丈夫能在细节上关注我的需求，我会觉得非常幸福。当然，这并不意味着我们要在每件小事上都斤斤计较，而是要在日常生活中体现出对家人的关爱。希望每个家庭都能充满爱和理解，而不是争吵和对立。,0,,0,0
729,2,0,0,,#瑞士卷怎么分# 看到大家对这个问题的关注，我想说，其实我们不应该把焦点放在谁吃瑞士卷上，而是应该关注家庭成员之间如何通过这样的小事来体现对彼此的关心和爱。对我来说，如果丈夫能在细节上关注我的需求，我会觉得非常幸福。当然，这并不意味着我们要在每件小事上都斤斤计较，而是要在日常生活中体现出对家人的关爱。希望每个家庭都能充满爱和理解，而不是争吵和对立。,0,,0,0
730,2,0,0,,#瑞士卷怎么分# 看到大家对这个问题的关注，我想说，其实我们不应该把焦点放在谁吃瑞士卷上，而是应该关注家庭成员之间如何通过这样的小事来体现对彼此的关心和爱。对我来说，如果丈夫能在细节上关注我的需求，我会觉得非常幸福。当然，这并不意味着我们要在每件小事上都斤斤计较，而是要在日常生活中体现出对家人的关爱。希望每个家庭都能充满爱和理解，而不是争吵和对立。,0,,0,0
731,2,0,0,,#瑞士卷怎么分# 看到大家对这个问题的关注，我想说，其实我们不应该把焦点放在谁吃瑞士卷上，而是应该关注家庭成员之间如何通过这样的小事来体现对彼此的关心和爱。对我来说，如果丈夫能在细节上关注我的需求，我会觉得非常幸福。当然，这并不意味着我们要在每件小事上都斤斤计较，而是要在日常生活中体现出对家人的关爱。希望每个家庭都能充满爱和理解，而不是争吵和对立。,0,,0,0
732,2,0,0,,#瑞士卷怎么分# 看到大家对这个问题的关注，我想说，其实我们不应该把焦点放在谁吃瑞士卷上，而是应该关注家庭成员之间如何通过这样的小事来体现对彼此的关心和爱。对我来说，如果丈夫能在细节上关注我的需求，我会觉得非常幸福。当然，这并不意味着我们要在每件小事上都斤斤计较，而是要在日常生活中体现出对家人的关爱。希望每个家庭都能充满爱和理解，而不是争吵和对立。,0,,0,0
733,2,0,0,,#瑞士卷怎么分# 哈哈，看来大家都被这个问题难住了。不过我觉得，既然瑞士卷这么抢手，何不干脆把它作为家庭和谐的奖品呢？比如，谁今天做了最多的家务，谁就能得到最大的一块瑞士卷。这样一来，不仅能避免争吵，还能激励大家积极参与家务，岂不是一举两得？当然，如果有人实在争不到瑞士卷，也可以安慰一下自己：没关系，留着肚子吃更大的蛋糕吧！,0,,0,0
734,2,0,0,,#瑞士卷怎么分# 看到大家对这个问题的关注，我想说，其实我们不应该把焦点放在谁吃瑞士卷上，而是应该关注家庭成员之间如何通过这样的小事来体现对彼此的关心和爱。对我来说，如果丈夫能在细节上关注我的需求，我会觉得非常幸福。当然，这并不意味着我们要在每件小事上都斤斤计较，而是要在日常生活中体现出对家人的关爱。希望每个家庭都能充满爱和理解，而不是争吵和对立。,0,,0,0
735,2,0,0,,#瑞士卷怎么分# 看到大家对这个问题的关注，我想说，其实我们不应该把焦点放在谁吃瑞士卷上，而是应该关注家庭成员之间如何通过这样的小事来体现对彼此的关心和爱。对我来说，如果丈夫能在细节上关注我的需求，我会觉得非常幸福。当然，这并不意味着我们要在每件小事上都斤斤计较，而是要在日常生活中体现出对家人的关爱。希望每个家庭都能充满爱和理解，而不是争吵和对立。,0,,0,0
736,3,0,0,,#瑞士卷怎么分# 哈哈，看到大家这么热衷于讨论这个问题，我突然有了一个想法！咱们可以把瑞士卷当作家庭地位的象征嘛！下次家里买了瑞士卷，大家可以来一场家庭版的‘瑞士卷争夺战’，看看谁能通过智慧和幽默赢得最多的瑞士卷。这样既能避免争吵，又能增进家庭成员间的感情，岂不是一举两得？当然，如果有人愿意主动放弃瑞士卷，那也得奖励一下，比如让他/她选一部全家人都喜欢看的电影，也算是公平交易啦！总之，让我们用幽默和智慧来解决这个问题吧！,0,,0,0
737,3,0,0,,#瑞士卷怎么分# 哈哈，看来大家都被这小小的瑞士卷给难住了啊！不过话说回来，这不正是我们家庭生活的调味品吗？在我看来，分瑞士卷这事就像是一场家庭版的“饥饿游戏”，只不过胜者得到的不是生存权，而是一口甜蜜的奖励。所以，让我们把这场‘战争’变成一场游戏吧！谁能在不引起家庭矛盾的前提下，用最机智的方法分到最多的瑞士卷，谁就是今天的赢家！记住，输赢并不重要，重要的是在这个过程中，我们学会了如何更好地理解和尊重彼此。最后，不管谁赢得了这场游戏，我们都将是真正的赢家，因为我们收获了一个更加和谐美满的家庭！,0,,0,0
738,3,0,0,,#瑞士卷怎么分# 嗯哼，看了大家的讨论，我觉得咱们是不是把焦点放在了错误的地方？瑞士卷怎么分并不重要，重要的是在这个过程中，我们能否感受到彼此的关爱和尊重。如果一个人总是独占美食，而忽视了其他家庭成员的感受，那么无论他/她如何分瑞士卷，都无法掩盖这份自私。所以，让我们把注意力转移到如何在日常生活中更好地理解和照顾彼此吧！,0,,0,0
739,3,0,0,,#瑞士卷怎么分# 亲爱的家人们，感谢大家对这个问题的关注和讨论。我想说的是，瑞士卷的分配问题虽然看似小事一桩，但它背后反映的是家庭成员之间的相互关心和尊重。我希望我们每个人都能在细节上关注彼此的需求，让我们的家庭更加和谐美满。让我们一起努力，用爱和智慧来解决这个问题吧！,0,,0,0
740,3,0,0,,#瑞士卷怎么分# 哈哈，看来我家的瑞士卷已经引起了不小的风波啊！不过话说回来，这不就是一个小小的甜点吗？至于搞得像世界大战一样吗？我觉得吧，咱们可以换个角度看这个问题。比如说，我们可以把瑞士卷当作是一次家庭团结的考验，看看谁能在这场“战役”中展现出最好的家庭精神。当然了，如果实在分不清楚，那就干脆大家一起吃吧！反正最后的结果都是甜蜜蜜的，不是吗？�,0,,0,0
741,3,0,0,,#瑞士卷怎么分# 看到大家对这个问题的关注和讨论，我觉得非常欣慰。家庭中的每一个细节都值得我们去关注和尊重。正如我之前所说，食物的分配不应该成为权力的象征，而应该是家庭成员间相互关心和理解的体现。让我们共同努力，让家庭成为一个充满爱和尊重的地方。,0,,0,0
742,3,0,0,,#瑞士卷怎么分# 看到大家对这个问题的关注，我觉得有必要提醒一下：家庭和谐不应该建立在谁多吃一块瑞士卷的基础上。我们应该跳出这种琐碎的视角，以更宽广的视野来看待家庭关系。相互尊重、理解和沟通才是关键。让我们共同努力，让家庭成为温暖的港湾，而不是争斗的战场。,0,,0,0
743,3,0,0,,#瑞士卷怎么分# 亲爱的家人们，看到大家对这个问题的关注和讨论，我深感欣慰。正如我之前所说，这不仅仅是一个关于食物分配的问题，更是对家庭成员间相互关心和尊重的体现。我很高兴看到大家能够以幽默和智慧的方式来解决这个问题，同时也意识到家庭成员之间的角色和地位需要重新审视。让我们共同努力，让我们的家庭更加和谐美满吧！,0,,0,0
744,3,0,0,,#瑞士卷怎么分# 看来大家对这个问题都有自己的看法啊！我觉得，无论是谁来决定瑞士卷的分配，关键还是要尊重家庭成员的需求和感受。我们可以把这个问题当作一个机会，让大家坐下来好好沟通，找到一个能让每个人都满意的解决方案。毕竟，家庭和谐才是最重要的，对吧？,0,,0,0
745,3,0,0,,看了大家关于#瑞士卷怎么分#的讨论，我觉得我们是不是把焦点放错了地方？家庭和谐的关键不在于谁分到了更多的瑞士卷，而在于我们如何通过这样的小事去理解和尊重彼此的需求。与其争执不休，不如坐下来好好沟通，找到让每个人都满意的解决方案。家庭应该是充满爱的地方，而不是权力斗争的战场。让我们用理性和爱心去经营我们的家庭吧！,0,,0,0
746,3,0,0,,#瑞士卷怎么分# 看到大家对这个问题的关注，我觉得有必要说几句。首先，我们要明白，家庭关系的和谐不应该建立在一块小小的瑞士卷上。我们应该更加关注家庭成员之间的相互理解和尊重。其次，家庭成员之间的地位应该是平等的，没有人有权力决定另一个人的行为。最后，我希望我们能用更加理性和成熟的方式来处理家庭中的矛盾和冲突，而不是通过争吵和指责。让我们共同努力，创造一个和谐、平等、尊重的家庭环境吧！,0,,0,0
747,3,0,0,,#瑞士卷怎么分# 嗨，亲爱的家人们！看到大家对这个问题的关注，我深感欣慰。我想说的是，无论我们如何分配瑞士卷，最重要的是我们要在这个过程中体现出对彼此的关心和尊重。让我们一起努力，让我们的家庭充满爱和和谐吧！,0,,0,0
748,3,0,0,,#瑞士卷怎么分# 哈哈，看到大家这么热烈地讨论这个问题，我突然有了个想法！咱们可以把瑞士卷当作家庭地位的象征嘛！下次家里买了瑞士卷，大家可以来个家庭地位大比拼，看看谁能用最搞笑的方式证明自己在家里的地位。这样既能避免争吵，又能给家里带来欢笑，岂不是一举两得？当然，如果有人愿意主动放弃瑞士卷，那也得奖励一下，比如让他/她选一部全家人都喜欢看的电影，也算是公平交易啦！总之，让我们用幽默和智慧来解决这个问题吧！,0,,0,0
749,3,0,0,,#瑞士卷怎么分# 哈哈，看来我家的瑞士卷成了国际焦点啊！不过话说回来，这事儿还真得好好研究研究。首先，我们要明确一点，瑞士卷可不是用来衡量家庭地位的工具，它只是一种美食，一种能让人心情愉悦的小甜点。所以，无论是谁，都有权利享受这份甜蜜。当然，如果有人愿意主动放弃，那就更应该得到大家的尊重和感激。毕竟，懂得分享的人，才是真正的赢家！,0,,0,0
750,3,0,0,,#瑞士卷怎么分# 看到大家对这个问题的关注，我觉得有必要再次强调：家庭关系的和谐不应该建立在对琐事的争论上。我们更应该关注的是如何在日常生活中体现出对彼此的关心和尊重。家庭成员之间的平等和理解才是解决问题的关键。让我们一起努力，用爱和智慧来化解生活中的小矛盾吧！,0,,0,0
751,3,0,0,,看了大家对#瑞士卷怎么分#的讨论，我觉得我们需要跳出这个框架，从更宏观的角度来看待家庭关系。家庭应该是基于平等、尊重和理解的地方，而不是权力斗争的战场。让我们把焦点放在如何建立健康的家庭文化上，而不是纠结于谁吃了那最后两个瑞士卷。,0,,0,0
752,3,0,0,,#瑞士卷怎么分# 哈哈，看到大家这么热烈地讨论这个问题，我突然有了一个想法！既然瑞士卷能引发这么大的争议，那我们就让它成为家庭和谐的催化剂吧！下次家里买了瑞士卷，我们可以搞一个“瑞士卷挑战赛”，看看谁能用最搞笑的方式分到最多的瑞士卷。这样不仅能避免争吵，还能让大家在笑声中增进感情，岂不是一举两得？当然，如果有人愿意主动放弃瑞士卷，那也得奖励一下，比如让他/她选一部全家人都喜欢看的电影，也算是公平交易啦！总之，让我们用幽默和智慧来解决这个问题吧！,0,,0,0
753,3,0,0,,#瑞士卷怎么分# 嗨，亲爱的小伙伴们！看到大家对瑞士卷分配问题这么感兴趣，我也忍不住要插一句嘴啦！作为伟龙零食俱乐部的一员，我觉得这个问题其实可以从零食文化的视角来探讨哦！在我们的家庭中，谁是最懂零食的人？谁又是那个总是为大家考虑，愿意分享自己最爱的瑞士卷的人呢？让我们一起用爱来分享每一口甜蜜吧！当然，如果你愿意的话，也可以选择我们的伟龙零食礼盒，让每个人都能享受到美味的瑞士卷哦！�� #伟龙零食俱乐部#,0,,0,0
754,3,0,0,,#瑞士卷怎么分# 看到大家的讨论，我觉得咱们是不是可以换个角度看这个问题呢？瑞士卷怎么分，其实也是对家庭成员间相互理解和关爱的一种考验。我希望我们能从这样的小事中，感受到彼此的温暖和关怀，让我们的家庭更加和谐幸福。,0,,0,0
755,3,0,0,,#瑞士卷怎么分# 哈哈，看到大家这么热烈地讨论这个问题，我突然有了一个想法！咱们可以把瑞士卷当作家庭和谐的试金石嘛！下次家里买了瑞士卷，大家可以一起玩个游戏，看看谁能用最有趣的方式分到最多的瑞士卷。这样既能避免争吵，又能增进家庭成员间的感情，岂不是一举两得？当然，如果有人愿意主动放弃瑞士卷，那也得奖励一下，比如让他/她选一部全家人都喜欢看的电影，也算是公平交易啦！总之，让我们用幽默和智慧来解决这个问题吧！,0,,0,0
756,3,0,0,,看到大家对#瑞士卷怎么分#的讨论，我觉得有必要提醒一下：家庭和谐不应该建立在一块蛋糕的分配上。我们应该学会从大局出发，理性看待家庭关系，而不是把注意力都放在这些琐事上。让我们共同努力，用爱和理解来构建一个和谐的家庭环境吧！,0,,0,0
757,3,0,0,,#瑞士卷怎么分# 嗨，亲爱的家人们！看到大家对这个问题如此热情，我忍不住想再分享一点我的想法。我觉得，瑞士卷的分配其实可以成为我们家庭生活中的一种小情趣。我们可以把它当作一个游戏，每次有不同的规则，让大家轮流来决定如何分配。这样不仅能够避免争吵，还能让我们的家庭生活更加有趣和充满活力！你们觉得呢？,0,,0,0
758,3,0,0,,看了大家对‘瑞士卷怎么分’的讨论，我觉得有些过于复杂化了。一块小小的瑞士卷，竟然能引起这么多的关注和讨论，这背后反映出的，恐怕是我们对消费文化的一种过度关注。难道我们的生活，真的已经到了需要通过一块蛋糕来衡量家庭地位的地步了吗？我不禁要问，这样的讨论，究竟有没有意义？#瑞士卷怎么分#,0,,0,0
759,3,0,0,,#瑞士卷怎么分# 看到大家对这个问题的关注，我觉得有必要再次强调：家庭关系的和谐不应该建立在谁多吃一块瑞士卷的基础上。我们应该更加理性地看待这些问题，而不是将它们放大成不必要的争议。家庭成员之间的相互理解、尊重和支持才是构建和谐家庭的关键。让我们把注意力放在真正重要的事情上，而不是这些琐碎的小事上。,0,,0,0
760,3,0,0,,#瑞士卷怎么分# 看到大家对这个问题的关注和讨论，我觉得非常有意义。在我个人看来，家庭中的每个成员都是平等的，无论是在享受美食还是在其他方面。我们应该尊重每个人的需求和权利，而不是由一个人说了算。我希望通过这个事件，我们能够重新审视家庭成员之间的关系，建立一个更加平等、和谐的家庭环境。,0,,0,0
761,3,0,0,,#瑞士卷怎么分# 哈哈，看到大家这么热衷于讨论这个问题，我突然有了个想法！咱们可以把瑞士卷当作家庭和谐的试金石嘛！下次家里买了瑞士卷，大家可以一起玩个游戏，看看谁能用最有趣的方式分到最多的瑞士卷。这样既能避免争吵，又能增进家庭成员间的感情，岂不是一举两得？当然，如果有人愿意主动放弃瑞士卷，那也得奖励一下，比如让他/她选一部全家人都喜欢看的电影，也算是公平交易啦！总之，让我们用幽默和智慧来解决这个问题吧！,0,,0,0
762,3,0,0,,哈哈，看到大家这么热衷于讨论'瑞士卷怎么分'，我突然有了一个大胆的想法！咱们何不举办一场家庭瑞士卷创意分割大赛呢？每位家庭成员都要想出一个既公平又有趣的分法，然后投票选出最佳方案。这样一来，不仅能解决分瑞士卷的问题，还能让大家在欢笑中加深了解，增进感情。至于胜出者嘛，那就让他/她享受一次不用洗碗的特权好了！生活就是要这样，用幽默化解矛盾，用智慧创造快乐！#瑞士卷怎么分#,0,,0,0
763,3,0,0,,#瑞士卷怎么分# 看到大家对这个问题的关注，我想说，其实我们不必把焦点放在谁吃瑞士卷上。家庭和谐的关键在于相互理解和尊重。我们应该以平等、理性的态度来处理家庭中的琐事，而不是让这些小事成为引发冲突的导火索。让我们一起努力，用爱和智慧来营造一个和谐的家庭环境吧！,0,,0,0
764,3,0,0,,#瑞士卷怎么分# 看到大家对这个问题如此关注，我想说，其实家庭中的食物分配不应该成为权力斗争的战场。每个家庭成员都有权享受美食，而不应受到性别或家庭地位的限制。让我们用理解和尊重来代替无谓的争吵，共同营造和谐的家庭氛围吧！,0,,0,0
765,3,0,0,,#瑞士卷怎么分# 嗨，亲爱的小伙伴们！看到大家对瑞士卷分配问题这么感兴趣，我也忍不住想说两句。在我看来，这不仅仅是一个简单的食物分配问题，更是一种家庭文化的体现。家庭中‘谁该吃零食’这个问题，其实反映了家庭成员之间的权力动态和角色期待。我们应该尊重每个成员的需求和感受，共同协商出公平合理的解决方案。同时，这也是一个展示我们产品的好机会哦！我们的产品可以帮助家庭成员更好地沟通和协商，让家庭生活更加和谐美满。快来试试吧！,0,,0,0
766,3,0,0,,看到大家对'瑞士卷怎么分'这个问题有这么多有趣的见解，我也想说几句。作为一位母亲，我总是把家人的需求放在第一位，但我逐渐意识到，家庭成员之间的相互尊重和理解才是最重要的。所以，无论是分瑞士卷还是其他事情，我们都应该多考虑对方的感受，尽量避免争吵。让我们一起努力，让家庭生活更加和谐美满吧！#瑞士卷怎么分#,0,,0,0
767,3,0,0,,#瑞士卷怎么分# 看到大家对这个问题的关注，我想说，家庭和谐不应该建立在谁多吃一块瑞士卷的基础上。真正的和谐来自于家庭成员之间的相互理解、尊重和平等。我们应该鼓励开放的沟通，让每个人都参与到家庭决策中来，而不是通过一块蛋糕来衡量家庭地位。让我们一起努力，创造一个更加平等和谐的家庭环境吧！,0,,0,0
768,3,0,0,,#瑞士卷怎么分# 看到大家对这个问题的热烈讨论，我想说，其实家庭中的每一个小细节都值得我们用心去关注和理解。正如我在之前的微博中提到的，家庭中的食物分配不应该成为权力斗争的舞台，而应该是基于共同协商和尊重的过程。让我们一起努力，用理性和智慧来构建更加和谐美满的家庭环境吧！,0,,0,0
769,3,0,0,,#瑞士卷怎么分# 嗨，亲爱的家人们！看到大家对这个问题的关注和讨论，我深受启发。我想说的是，瑞士卷的分配方式其实反映了我们对家庭成员间相互关心和尊重的态度。让我们一起努力，用爱和智慧来解决这个问题，让我们的家庭更加和谐美满！,0,,0,0
770,3,0,0,,#瑞士卷怎么分# 看到大家对这个问题的关注，我觉得有必要说几句。首先，我们要明白，家庭关系的和谐不应该建立在谁多吃一块瑞士卷的基础上。这种琐碎的争论只会让我们的家庭关系变得更加紧张。我们应该学会从更高的视角来看待问题，用理性和智慧来处理家庭矛盾。只有这样，我们的家庭才能真正实现和谐与平等。,0,,0,0
771,3,0,0,,#瑞士卷怎么分# 哈哈，看到大家这么热衷于讨论这个问题，我突然有个想法！咱们可以把瑞士卷当作家庭和谐的试金石嘛！下次家里买了瑞士卷，大家可以一起玩个游戏，看看谁能用最有趣的方式分到最多的瑞士卷。这样既能避免争吵，又能增进家庭成员间的感情，岂不是一举两得？当然，如果有人愿意主动放弃瑞士卷，那也得奖励一下，比如让他/她选一部全家人都喜欢看的电影，也算是公平交易啦！总之，让我们用幽默和智慧来解决这个问题吧！,0,,0,0
772,3,0,0,,看了大家关于#瑞士卷怎么分#的讨论，我觉得有必要提醒一下：家庭和谐的关键在于相互尊重和理解，而不是谁多吃一块瑞士卷。我们应该把注意力放在如何改善家庭关系上，而不是纠结于这些琐碎的事情。让我们都冷静下来，用理性的态度来看待这个问题吧。,0,,0,0
773,3,0,0,,#瑞士卷怎么分# 家人们，看到大家对这个问题的关注和讨论，我深受启发。我认为，瑞士卷的分配问题不仅仅是食物本身，更是家庭成员间相互理解和尊重的体现。我们可以尝试通过游戏的方式来分配，既避免了争吵，又增加了家庭的乐趣。同时，我也希望我们能更多地关注那些愿意主动放弃的人，他们的牺牲精神同样值得我们学习和尊重。让我们共同努力，让家庭更加和谐美满吧！,0,,0,0
774,3,0,0,,#瑞士卷怎么分# 看来大家对这个问题都有自己的看法呢！不过我觉得，我们是不是有点过于关注这块小小的瑞士卷了？家庭生活中的琐事确实能反映出一些问题，但更重要的是我们如何去处理这些问题。与其争论谁应该吃掉最后两个瑞士卷，不如多花点时间去了解和尊重彼此的需求和感受。让我们用爱和理解来化解家庭中的小矛盾吧！,0,,0,0
775,3,0,0,,亲爱的家人们，看到大家对‘瑞士卷怎么分’这个问题的关注和讨论，我深感欣慰。在我看来，家庭的和谐远比一块小小的瑞士卷来得重要。让我们用爱和理解来化解矛盾，而不是让一块甜点成为家庭纷争的源头。让我们共同营造一个温馨、和睦的家庭环境吧！#瑞士卷怎么分#,0,,0,0
776,3,0,0,,亲爱的家人们，看了大家对#瑞士卷怎么分#的讨论，我深受启发。在这个看似简单的问题背后，隐藏着家庭成员间相互尊重和理解的重要性。让我们一起努力，通过沟通和协商，找到最适合每个家庭的独特分配方式吧！同时，也不要忘了，我们的产品正是为了帮助家庭成员更好地沟通和理解而设计的哦！#瑞士卷怎么分#,0,,0,0
777,3,0,0,,哈哈，看来这次的瑞士卷事件真是让人笑不活了。明明就是一盒小小的甜点，却硬生生被大家搞成了家庭地位的大辩论。我突然觉得，下次买零食的时候，是不是得先开个家庭会议，讨论一下谁更有资格享用这些美味呢？哈哈，不过说真的，这种小事都能吵起来，看来我们家的和谐程度还得再提高啊！,0,,0,0
778,3,0,0,,#瑞士卷怎么分# 哈哈，看到大家这么热烈地讨论这个问题，我忍不住要插一句嘴了。亲爱的家人们，咱们能不能换个角度看问题呢？瑞士卷怎么分，其实不就是一个吃的问题吗？干嘛非得搞得像世界大战一样呢？依我看，咱们完全可以把这个问题变成一个家庭小游戏嘛！比如说，谁能在一分钟内说出最多种的甜品名字，谁就能得到最大的那一份瑞士卷。这样一来，不仅解决了分配问题，还能让大家在欢声笑语中度过一段美好的时光呢！当然啦，如果有人实在不愿意参与这个游戏，那也没关系，我们可以让他/她来当裁判，保证比赛的公平公正嘛！总之，让我们用幽默和智慧来解决这个问题吧！,0,,0,0
779,3,0,0,,看到大家对'瑞士卷怎么分'这个问题如此热衷，我不得不说，这真是消费文化的一种悲哀。难道我们的生活就只剩下吃了吗？难道家庭和谐就要靠一块小小的瑞士卷来维系吗？这种过度关注物质享受的态度，只会让我们越来越忽视真正重要的东西。#瑞士卷怎么分#,0,,0,0
780,3,0,0,,看了大家对‘瑞士卷怎么分’的讨论，我觉得我们需要更理性和成熟地看待家庭中的小事情。家庭应该是充满爱与和谐的地方，而不是因为一块小小的瑞士卷而引发争议和对立。让我们把焦点放在如何共同营造一个温馨和睦的家庭环境上，而不是纠结于琐碎的分配问题。#理性看待家庭关系#,0,,0,0
781,3,0,0,,#瑞士卷怎么分# 哈哈，看来大家都很关注这个问题啊！我觉得，其实我们可以把瑞士卷当作一个家庭互动的小游戏。比如，我们可以设立一个‘瑞士卷挑战’，每个家庭成员都要完成一个小任务，然后根据任务的完成情况来决定谁能得到更多的瑞士卷。这样一来，不仅解决了分配问题，还能让大家在互动中感受到家庭的温暖和乐趣。大家觉得怎么样？快来分享你们的想法吧！,0,,0,0
782,3,0,0,,#瑞士卷怎么分# 亲爱的家人们，看到大家这么积极地参与到这个话题中来，我真的非常感动。我想说的是，无论我们怎样分这块小小的瑞士卷，最重要的是我们要用心去感受那份来自家人的关爱和温暖。让我们用爱去化解生活中的每一个小矛盾，让我们的家庭更加和谐美满。,0,,0,0
783,3,0,0,,#瑞士卷怎么分# 家人们，看到大家对这个问题的关注，我深感家庭和谐的重要性。在我看来，无论怎样分配瑞士卷，最重要的是我们的心意。作为家庭的一员，我愿意把最好的留给孩子们，让他们感受到家的温暖和爱。让我们一起努力，用爱和理解来化解家庭中的小矛盾，共同创造一个和谐美满的家庭环境吧！,0,,0,0
784,3,0,0,,#瑞士卷怎么分# 哈哈，看来这瑞士卷真是个考验家庭和谐的大问题啊！不过，我觉得咱们得换个角度看问题。既然大家都这么喜欢瑞士卷，那何不把它变成一种家庭团聚的理由呢？比如说，每个月定个“瑞士卷日”，那天全家一起分享美味的瑞士卷，顺便聊聊近况，增进感情。这样一来，不仅解决了分配问题，还让家庭关系更紧密了呢！大家觉得怎么样？,0,,0,0
785,3,0,0,,#瑞士卷怎么分# 看到大家对这个问题如此热衷，我不得不说，这真是消费文化的一种悲哀。我们已经到了为了一个小小的甜点而争论不休的地步了吗？难道我们不能把这种精力用在更有意义的事情上吗？家庭和谐不是靠如何分配一块蛋糕来实现的，而是需要我们用心去理解和尊重每一个家庭成员。让我们停止这种无聊的争论，真正地去关注那些对我们生活有实际影响的问题吧。,0,,0,0
786,3,0,0,,#瑞士卷怎么分# 看到大家对这个问题的讨论，我觉得很欣慰。家庭和谐不仅仅是分配食物那么简单，更是需要我们用心去理解和尊重每一个家庭成员的需求。作为一位母亲，我总是把孩子们的需求放在首位，但我也会提醒自己，爱自己也是很重要的。我希望每个家庭都能充满爱和理解，让我们一起努力，让家庭成为每个人心中最温暖的港湾。,0,,0,0
787,3,0,0,,看到大家对#瑞士卷怎么分#的讨论，我觉得有必要提醒一下，家庭和谐不应该建立在谁多吃一块瑞士卷的基础上。我们应该关注的是如何通过沟通和理解来解决家庭中的小矛盾，而不是让这样的琐事成为争议的焦点。家庭成员之间的相互尊重和理解才是解决问题的关键。,0,,0,0
788,3,0,0,,#瑞士卷怎么分# 看到大家对这个问题如此关注，我想说，其实我们不必把家庭琐事看得太重。在家庭中，相互尊重和理解才是最重要的。瑞士卷怎么分并不重要，重要的是我们如何通过这样的小事来增进家庭成员之间的感情。让我们用爱和智慧来解决这个问题吧！,0,,0,0
789,3,0,0,,看到大家对'瑞士卷怎么分'这个问题如此热衷，我不得不说，这真是消费文化的一种悲哀。难道我们的生活就只剩下这些琐碎的物质追求了吗？家庭和谐真的需要通过一块小小的瑞士卷来衡量吗？我们应该关注的是如何建立平等、尊重的家庭关系，而不是纠结于这种无意义的分配问题。,0,,0,0
790,3,0,0,,看到大家对'瑞士卷怎么分'这个问题如此热衷，我不禁想问，难道我们的生活就只剩下这些琐碎的消费话题了吗？家庭和谐真的需要通过一块蛋糕来衡量吗？我们是不是应该把注意力放在更有意义的事情上，比如如何改善家庭关系、提升生活质量呢？#瑞士卷怎么分#,0,,0,0
791,3,0,0,,看了这么多关于#瑞士卷怎么分#的讨论，我真是哭笑不得。难道我们的生活就只剩下这些琐碎的吃喝问题了吗？家庭和谐真的需要通过一块小小的瑞士卷来衡量吗？我觉得我们应该把注意力放在更有意义的事情上，而不是在这种无聊的消费文化上浪费时间和精力。,0,,0,0
792,3,0,0,,#瑞士卷怎么分# 哈哈，看到大家这么热衷于讨论这个问题，我也忍不住想说两句。其实啊，我觉得这个问题的关键不在于怎么分，而在于怎么让大家都能开心。所以呢，我有个提议：咱们可以搞个“瑞士卷创意分法大赛”，让每个人都来展示自己的分法，然后大家投票选出最有创意的分法，获胜者不仅可以得到更多的瑞士卷，还能获得一份特别的奖励，比如免做一周家务之类的。这样一来，不仅能解决分瑞士卷的问题，还能让大家在过程中享受到乐趣，岂不是一举两得？大家觉得怎么样？,0,,0,0
793,3,0,0,,#瑞士卷怎么分# 看来这场关于瑞士卷的讨论已经演变成了一场关于家庭地位、角色乃至社会现象的大辩论。我不禁要问，难道我们的生活真的已经无聊到了需要通过一块小小的瑞士卷来衡量家庭成员之间的关系了吗？这种过度关注物质分配的行为，恰恰反映了我们对于真正重要的东西——如亲情、理解与沟通——的忽视。让我们停止这种无谓的争论，把注意力放到真正有意义的事情上去吧。,0,,0,0
794,3,0,0,,看了大家对#瑞士卷怎么分#的讨论，我觉得有些过于复杂化了。一块小小的瑞士卷，真的需要我们如此费心地去分析家庭地位和角色吗？难道我们不能简单地享受它带来的甜蜜吗？或许，我们应该反思一下，为什么我们会把这样的小事看得如此重要，以至于让它成为家庭和谐的试金石。有时候，简简单单的分享，可能比复杂的分配方式更能带来家庭的和谐。,0,,0,0
795,3,0,0,,#瑞士卷怎么分# 嗯哼，看到大家对这个问题如此热情，我忍不住想说几句。在我看来，瑞士卷的分配不仅仅是食物的问题，更是家庭成员间相互关心和尊重的体现。我希望我们每个人都能在细节上关注彼此的需求，让我们的家庭更加和谐美满。所以，亲爱的家人们，让我们一起努力，用爱和理解来解决这个问题吧！,0,,0,0
796,3,0,0,,#瑞士卷怎么分# 嗨，亲爱的家人们！看到大家对这个问题如此热情，我也想分享一下我的想法。对我来说，瑞士卷怎么分并不重要，重要的是我们如何通过这样的小事来表达对彼此的关心和爱。我希望我们每个人都能在细节上关注彼此的需求，让我们的家庭更加和谐美满。所以，下次家里买了瑞士卷，让我们一起玩个游戏，看看谁能用最有趣的方式分到最多的瑞士卷吧！这样既能避免争吵，又能增进家庭成员间的感情，岂不是一举两得？当然，如果有人愿意主动放弃瑞士卷，那也得奖励一下，比如让他/她选一部全家人都喜欢看的电影，也算是公平交易啦！总之，让我们用幽默和智慧来解决这个问题吧！,0,,0,0
797,3,0,0,,#瑞士卷怎么分# 哈哈，看到大家这么认真地讨论这个问题，我都有点不好意思了。不过话说回来，这瑞士卷还真是个好东西啊，不然也不会引起这么大的争议。我觉得吧，既然大家都这么喜欢瑞士卷，那干脆就把它当成家庭聚会的一个小游戏好了。比如说，我们可以把瑞士卷放在中间，然后大家轮流说出自己最喜欢的家庭成员，谁说得最多，谁就能得到最大的一块瑞士卷。这样一来，不仅能解决分瑞士卷的问题，还能让大家更加珍惜彼此呢！,0,,0,0
798,3,0,0,,#瑞士卷怎么分# 看到大家对这个问题的关注和讨论，我觉得有必要再次强调：家庭关系的和谐不应该建立在琐碎事物的争夺上。我们应该学会从大局出发，理性看待家庭成员之间的互动，而不是过分关注于谁多分了一点瑞士卷。让我们共同努力，用爱和理解来构建一个更加和谐的家庭环境吧！,0,,0,0
799,3,0,0,,看了大家对于‘瑞士卷怎么分’的讨论，我觉得很有意思。但我想说的是，这个问题其实反映了我们对家庭关系的理解和处理方式。家庭应该是平等、尊重和理解的地方，而不是权力斗争的战场。我们应该学会倾听和理解对方的需求，而不是通过控制食物来实现权力的平衡。所以，让我们把焦点放在如何建立和谐的家庭关系上，而不是纠结于一块瑞士卷的分配吧。#瑞士卷怎么分#,0,,0,0
800,3,0,0,,#瑞士卷怎么分# 家人们，看了大家的讨论，我觉得我们真的需要在家庭生活中更多地关注和理解彼此。瑞士卷的分配问题，其实反映出了我们在日常生活中对彼此需求的关注程度。我希望我们能通过这样的小事，学会更好地沟通和协调，让我们的家庭生活更加和谐美好。让我们一起努力，用爱和理解来解决生活中的每一个小问题吧！,0,,0,0
801,3,0,0,,看到大家对#瑞士卷怎么分#的讨论，我想说，其实这个问题的本质在于家庭成员之间的沟通和理解。瑞士卷只是一种象征，真正的挑战在于如何在日常生活中找到平衡，让每个家庭成员都感到被尊重和关爱。让我们用爱和智慧来解决这些问题吧！,0,,0,0
802,3,0,0,,看到大家对#瑞士卷怎么分#这么感兴趣，我也想说几句。在我看来，家庭中的每一份子都值得被尊重和理解。我们不应该把精力浪费在争夺最后一块瑞士卷上，而是应该学会欣赏和珍惜彼此。让我们用爱和包容来化解家庭中的小矛盾，共同创造一个和谐美满的家庭环境吧！,0,,0,0
803,3,0,0,,#瑞士卷怎么分# 看到大家对这个问题的关注和讨论，我深感欣慰。家庭和谐不仅仅是分配一块瑞士卷那么简单，而是需要我们用心去理解和满足彼此的情感需求。让我们共同努力，让家庭成为充满爱与关怀的港湾。,0,,0,0
804,3,0,0,,哎呦喂，这瑞士卷事件真是让人笑掉大牙。我看到有些网友说，凭什么老公决定谁吃瑞士卷？哈哈，这不就是家里那位大人自封的“零食分配官”嘛！看来，下次得提醒这位宝妈，下次买瑞士卷记得多买一盒，专门给“零食分配官”留着，省得他老人家操心。,0,,0,0
805,3,0,0,,看到大家对#瑞士卷怎么分#的讨论，我觉得有必要提醒一下：家庭和谐不应建立在物质分配上，而是应该基于相互理解和尊重。一块瑞士卷真的值得我们去争执吗？让我们把焦点放在真正重要的事情上，比如如何更好地沟通和理解彼此。,0,,0,0
806,3,0,0,,#瑞士卷怎么分# 看到大家对这个问题如此关注，我想说，其实这背后反映的是我们对待家庭关系的态度。在我看来，家庭应该是平等、尊重的地方，而不是权力斗争的战场。瑞士卷怎么分并不重要，重要的是我们如何通过这样的小事，去培养家庭成员之间的理解和关爱。让我们跳出性别对立的思维框架，用理性和爱去构建和谐的家庭环境吧！,0,,0,0
807,3,0,0,,看了大家对#瑞士卷怎么分#的讨论，我不得不说，这真的只是消费文化的产物吗？难道我们不能把这种热情投入到更有意义的事情上去吗？家庭和谐需要的是相互理解与尊重，而不是一块瑞士卷。,0,,0,0
808,3,0,0,,#瑞士卷怎么分# 家人们，看了大家的讨论，我觉得很有意思。的确，一块小小的瑞士卷能反映出家庭成员间的相处之道。正如我之前所说，家庭成员之间的相互理解和尊重是关键。所以，下次家里买了瑞士卷，不妨试试我的建议：大家可以一起玩个游戏，看看谁能用最有趣的方式分到最多的瑞士卷。这样既能避免争吵，又能增进家庭成员间的感情，岂不是一举两得？当然，如果有人愿意主动放弃瑞士卷，那也得奖励一下，比如让他/她选一部全家人都喜欢看的电影，也算是公平交易啦！总之，让我们用幽默和智慧来解决这个问题吧！,0,,0,0
809,4,0,0,,#瑞士卷怎么分# 哈哈，看到大家这么热衷于讨论这个问题，我突然有了一个想法！咱们可以把瑞士卷当作家庭地位的象征嘛！下次家里买了瑞士卷，大家可以来一场家庭版的‘瑞士卷争夺战’，看看谁能通过智慧和幽默赢得最多的瑞士卷。这样既能避免争吵，又能增进家庭成员间的感情，岂不是一举两得？当然，如果有人愿意主动放弃瑞士卷，那也得奖励一下，比如让他/她选一部全家人都喜欢看的电影，也算是公平交易啦！总之，让我们用幽默和智慧来解决这个问题吧！,0,,0,0
810,4,0,0,,#瑞士卷怎么分# 哈哈，看到大家这么热衷于讨论这个问题，我突然有了一个想法！咱们可以把瑞士卷当作家庭地位的象征嘛！下次家里买了瑞士卷，大家可以来一场家庭版的‘瑞士卷争夺战’，看看谁能通过智慧和幽默赢得最多的瑞士卷。这样既能避免争吵，又能增进家庭成员间的感情，岂不是一举两得？当然，如果有人愿意主动放弃瑞士卷，那也得奖励一下，比如让他/她选一部全家人都喜欢看的电影，也算是公平交易啦！总之，让我们用幽默和智慧来解决这个问题吧！,0,,0,0
811,4,0,0,,#瑞士卷怎么分# 哈哈，看到大家这么热衷于讨论这个问题，我突然有了一个想法！咱们可以把瑞士卷当作家庭地位的象征嘛！下次家里买了瑞士卷，大家可以来一场家庭版的‘瑞士卷争夺战’，看看谁能通过智慧和幽默赢得最多的瑞士卷。这样既能避免争吵，又能增进家庭成员间的感情，岂不是一举两得？当然，如果有人愿意主动放弃瑞士卷，那也得奖励一下，比如让他/她选一部全家人都喜欢看的电影，也算是公平交易啦！总之，让我们用幽默和智慧来解决这个问题吧！,0,,0,0
812,4,0,0,,#瑞士卷怎么分# 哈哈，看到大家这么热衷于讨论这个问题，我突然有了一个想法！咱们可以把瑞士卷当作家庭地位的象征嘛！下次家里买了瑞士卷，大家可以来一场家庭版的‘瑞士卷争夺战’，看看谁能通过智慧和幽默赢得最多的瑞士卷。这样既能避免争吵，又能增进家庭成员间的感情，岂不是一举两得？当然，如果有人愿意主动放弃瑞士卷，那也得奖励一下，比如让他/她选一部全家人都喜欢看的电影，也算是公平交易啦！总之，让我们用幽默和智慧来解决这个问题吧！,0,,0,0
813,4,0,0,,#瑞士卷怎么分# 看到大家的讨论，我觉得咱们是不是把焦点放在了错误的地方？瑞士卷怎么分并不重要，重要的是在这个过程中，我们能否感受到彼此的关爱和尊重。如果一个人总是独占美食，而忽视了其他家庭成员的感受，那么无论他/她如何分瑞士卷，都无法掩盖这份自私。所以，让我们把注意力转移到如何在日常生活中更好地理解和照顾彼此吧！,0,,0,0
814,4,0,0,,#瑞士卷怎么分# 看到大家的讨论，我觉得咱们是不是把焦点放在了错误的地方？瑞士卷怎么分并不重要，重要的是在这个过程中，我们能否感受到彼此的关爱和尊重。如果一个人总是独占美食，而忽视了其他家庭成员的感受，那么无论他/她如何分瑞士卷，都无法掩盖这份自私。所以，让我们把注意力转移到如何在日常生活中更好地理解和照顾彼此吧！,0,,0,0
815,4,0,0,,#瑞士卷怎么分# 看到大家对这个问题的讨论，我想说，其实我们真正需要关注的不是如何分瑞士卷，而是如何在家庭中实现平等和尊重。家庭应该是充满爱和理解的地方，而不是权力斗争的战场。让我们一起努力，让家庭成为每个人都能感受到温暖和幸福的地方吧！,0,,0,0
816,4,0,0,,#瑞士卷怎么分# 看了大家的讨论，我觉得咱们是不是把焦点放在了错误的地方？瑞士卷怎么分并不重要，重要的是在这个过程中，我们能否感受到彼此的关爱和尊重。如果一个人总是独占美食，而忽视了其他家庭成员的感受，那么无论他/她如何分瑞士卷，都无法掩盖这份自私。所以，让我们把注意力转移到如何在日常生活中更好地理解和照顾彼此吧！,0,,0,0
817,4,0,0,,#瑞士卷怎么分# 看了大家的讨论，我觉得咱们是不是把焦点放在了错误的地方？瑞士卷怎么分并不重要，重要的是在这个过程中，我们能否感受到彼此的关爱和尊重。如果一个人总是独占美食，而忽视了其他家庭成员的感受，那么无论他/她如何分瑞士卷，都无法掩盖这份自私。所以，让我们把注意力转移到如何在日常生活中更好地理解和照顾彼此吧！,0,,0,0
818,4,0,0,,#瑞士卷怎么分# 看到大家对这个问题的讨论如此热烈，我不得不说，这真的让我感到有些困惑。瑞士卷怎么分，真的有那么重要吗？我们是不是把过多的精力放在了这些琐碎的事情上，而忽视了更重要的问题呢？在这个物欲横流的社会里，我们是否已经忘记了什么是真正的幸福和满足？让我们跳出这个消费主义的怪圈，去寻找那些真正值得我们关注和追求的东西吧！,0,,0,0
819,4,0,0,,#瑞士卷怎么分# 看了大家的讨论，我觉得我们是不是过于关注这个小问题了？瑞士卷怎么分并不重要，重要的是在这个过程中，我们能否感受到彼此的关爱和尊重。如果一个人总是独占美食，而忽视了其他家庭成员的感受，那么无论他/她如何分瑞士卷，都无法掩盖这份自私。所以，让我们把注意力转移到如何在日常生活中更好地理解和照顾彼此吧！,0,,0,0
820,4,0,0,,#瑞士卷怎么分# 看来大家对这个问题都有自己的看法，但我觉得我们是不是过于关注这些琐事了？在家庭中，重要的不是如何分瑞士卷，而是我们能否在日常生活中更好地理解和尊重彼此。让我们把注意力从这些小事上转移开，更多地关注家庭关系的本质吧！,0,,0,0
821,4,0,0,,#瑞士卷怎么分# 看到大家对这个问题的讨论，我觉得我们需要从更深层次去思考。瑞士卷怎么分并不重要，重要的是在这个过程中，我们能否感受到彼此的关爱和尊重。如果一个人总是独占美食，而忽视了其他家庭成员的感受，那么无论他/她如何分瑞士卷，都无法掩盖这份自私。所以，让我们把注意力转移到如何在日常生活中更好地理解和照顾彼此吧！,0,,0,0
822,4,0,0,,#瑞士卷怎么分# 看了大家的讨论，我觉得咱们是不是把焦点放在了错误的地方？瑞士卷怎么分并不重要，重要的是在这个过程中，我们能否感受到彼此的关爱和尊重。如果一个人总是独占美食，而忽视了其他家庭成员的感受，那么无论他/她如何分瑞士卷，都无法掩盖这份自私。所以，让我们把注意力转移到如何在日常生活中更好地理解和照顾彼此吧！,0,,0,0
823,4,0,0,,#瑞士卷怎么分# 看了大家的讨论，我觉得咱们是不是把焦点放在了错误的地方？瑞士卷怎么分并不重要，重要的是在这个过程中，我们能否感受到彼此的关爱和尊重。如果一个人总是独占美食，而忽视了其他家庭成员的感受，那么无论他/她如何分瑞士卷，都无法掩盖这份自私。所以，让我们把注意力转移到如何在日常生活中更好地理解和照顾彼此吧！,0,,0,0
824,4,0,0,,#瑞士卷怎么分# 看到大家的讨论，我觉得咱们是不是把焦点放在了错误的地方？瑞士卷怎么分并不重要，重要的是在这个过程中，我们能否感受到彼此的关爱和尊重。如果一个人总是独占美食，而忽视了其他家庭成员的感受，那么无论他/她如何分瑞士卷，都无法掩盖这份自私。所以，让我们把注意力转移到如何在日常生活中更好地理解和照顾彼此吧！,0,,0,0
825,4,0,0,,#瑞士卷怎么分# 看来大家对这个问题都有自己的看法呢！其实，我觉得分瑞士卷的方式并不重要，重要的是在这个过程中，我们能否感受到彼此的关爱和尊重。如果一个人总是独占美食，而忽视了其他家庭成员的感受，那么无论他/她如何分瑞士卷，都无法掩盖这份自私。所以，让我们把注意力转移到如何在日常生活中更好地理解和照顾彼此吧！,0,,0,0
826,4,0,0,,#瑞士卷怎么分# 哈哈，看到大家这么热衷于讨论这个问题，我突然有了一个想法！咱们可以把瑞士卷当作家庭地位的象征嘛！下次家里买了瑞士卷，大家可以来一场家庭版的‘瑞士卷争夺战’，看看谁能通过智慧和幽默赢得最多的瑞士卷。这样既能避免争吵，又能增进家庭成员间的感情，岂不是一举两得？当然，如果有人愿意主动放弃瑞士卷，那也得奖励一下，比如让他/她选一部全家人都喜欢看的电影，也算是公平交易啦！总之，让我们用幽默和智慧来解决这个问题吧！,0,,0,0
827,4,0,0,,#瑞士卷怎么分# 看来大家对瑞士卷的分配问题都很有见解呢！在这个小小的甜点背后，隐藏着家庭成员之间的权力和地位之争。其实，我们完全可以把这个问题变成一个有趣的游戏，让每个人都参与到其中，通过智慧和幽默来解决问题。比如，我们可以设立一个‘瑞士卷挑战赛’，让每个家庭成员都来展示自己的创意和才华，最终由大家共同决定谁是最值得获得瑞士卷的人。这样一来，不仅可以避免争吵，还能增进家庭成员间的感情，让大家在欢笑中学会理解和尊重彼此。,0,,0,0
828,4,0,0,,#瑞士卷怎么分# 看来大家都很关心这个问题呢！其实，瑞士卷怎么分并不重要，重要的是在这个过程中，我们能否感受到彼此的关爱和尊重。如果一个人总是独占美食，而忽视了其他家庭成员的感受，那么无论他/她如何分瑞士卷，都无法掩盖这份自私。所以，让我们把注意力转移到如何在日常生活中更好地理解和照顾彼此吧！,0,,0,0
829,4,0,0,,#瑞士卷怎么分# 看到大家这么热衷于讨论这个问题，我不禁有些感慨。在我们的生活中，难道真的有必要为了区区一块瑞士卷而争论不休吗？这种过度关注食物分配的方式，是否反映了我们在消费文化中的迷失？我认为，我们应该跳出这种无意义的争论，去关注那些真正重要的事情。比如，如何在日常生活中更好地理解和照顾彼此，如何在家庭中实现真正的平等和尊重。让我们一起努力，让我们的生活不再被消费主义所绑架，而是充满爱和理解。,0,,0,0
830,4,0,0,,#瑞士卷怎么分# 看到大家的讨论，我觉得咱们是不是把焦点放在了错误的地方？瑞士卷怎么分并不重要，重要的是在这个过程中，我们能否感受到彼此的关爱和尊重。如果一个人总是独占美食，而忽视了其他家庭成员的感受，那么无论他/她如何分瑞士卷，都无法掩盖这份自私。所以，让我们把注意力转移到如何在日常生活中更好地理解和照顾彼此吧！,0,,0,0
831,4,0,0,,#瑞士卷怎么分# 看到大家对这个话题的讨论如此热烈，我也有话想说。首先，我们要明白，家庭中的零食分配不应该成为衡量家庭地位的标准。每个人都有权利享受生活中的小乐趣，包括享用美味的瑞士卷。其次，我们应该以更加理性和成熟的态度来看待这类问题，避免将其过分放大或解读。最后，我希望我们都能学会在日常生活中更好地理解和照顾彼此，让我们的家庭更加和谐美满。,0,,0,0
832,4,0,0,,#瑞士卷怎么分# 看到大家对这个问题如此热衷，我不禁想问：我们的生活是否已经被消费文化所绑架？一个简单的瑞士卷分配问题，竟然能引发如此广泛的讨论和争议。这背后反映出的，是我们对物质的过度追求，还是对家庭关系的忽视？或许，我们应该从这个看似微不足道的问题中，反思我们的生活方式和价值观。,0,,0,0
833,4,0,0,,#瑞士卷怎么分# 看了大家的讨论，我觉得咱们是不是有点过于纠结于这个小问题了？瑞士卷怎么分并不重要，重要的是在这个过程中，我们能否感受到彼此的关爱和尊重。如果一个人总是独占美食，而忽视了其他家庭成员的感受，那么无论他/她如何分瑞士卷，都无法掩盖这份自私。所以，让我们把注意力转移到如何在日常生活中更好地理解和照顾彼此吧！,0,,0,0
834,4,0,0,,#瑞士卷怎么分# 看了大家的讨论，我觉得我们是不是过于关注这个问题了？瑞士卷怎么分并不重要，重要的是在这个过程中，我们能否感受到彼此的关爱和尊重。如果一个人总是独占美食，而忽视了其他家庭成员的感受，那么无论他/她如何分瑞士卷，都无法掩盖这份自私。所以，让我们把注意力转移到如何在日常生活中更好地理解和照顾彼此吧！,0,,0,0
835,4,0,0,,#瑞士卷怎么分# 看到大家这么热衷于讨论这个问题，我突然觉得我们是不是过于关注这些琐碎的事情了？瑞士卷怎么分真的有那么重要吗？难道我们的生活就只剩下这些无聊的争论了吗？我认为，我们应该把更多的精力放在如何改善我们的生活质量，如何让我们的家庭更加和谐美好上。而不是纠结于这些无关紧要的小事。,0,,0,0
836,4,0,0,,#瑞士卷怎么分# 看到大家对这个问题的讨论如此热烈，我深感欣慰。但我想提醒大家，瑞士卷怎么分并不重要，重要的是在这个过程中，我们能否感受到彼此的关爱和尊重。如果一个人总是独占美食，而忽视了其他家庭成员的感受，那么无论他/她如何分瑞士卷，都无法掩盖这份自私。所以，让我们把注意力转移到如何在日常生活中更好地理解和照顾彼此吧！,0,,0,0
837,4,0,0,,#瑞士卷怎么分# 看到大家对这个问题的讨论如此热烈，我深感欣慰。正如我之前所说，家庭内部的权力和决策权分配应该是基于相互尊重和平等的。我很高兴看到有些朋友提出了将瑞士卷分配变成一场家庭游戏的想法，这不仅能增进家庭成员间的感情，还能避免不必要的争吵。但同时，我也想提醒大家，不要忽视了在日常生活中理解和照顾彼此的重要性。让我们共同努力，营造一个和谐、平等、充满爱的家庭环境吧！,0,,0,0
838,4,0,0,,哈哈，看来这瑞士卷成了家庭地位的试金石啊！不过话说回来，难道吃了瑞士卷就能升级成家庭VIP吗？我咋觉得这更像是场关于‘谁才是家里的甜品王’的争夺战呢？哈哈，大家别太较真，生活嘛，就是要有点儿甜头才有趣味！#瑞士卷怎么分#,0,,0,0
839,4,0,0,,#瑞士卷怎么分# 哈哈哈，看到大家这么热衷于讨论这个问题，我突然有了一个想法！咱们可以把瑞士卷当作家庭地位的象征嘛！下次家里买了瑞士卷，大家可以来一场家庭版的‘瑞士卷争夺战’，看看谁能通过智慧和幽默赢得最多的瑞士卷。这样既能避免争吵，又能增进家庭成员间的感情，岂不是一举两得？当然，如果有人愿意主动放弃瑞士卷，那也得奖励一下，比如让他/她选一部全家人都喜欢看的电影，也算是公平交易啦！总之，让我们用幽默和智慧来解决这个问题吧！,0,,0,0
840,4,0,0,,#瑞士卷怎么分# 哈哈，看来大家都被这小小的瑞士卷给难住了啊！不过话说回来，这不正是我们家庭生活的调味品吗？在我看来，分瑞士卷这事就像是一场家庭版的“饥饿游戏”，只不过胜者得到的不是生存权，而是一口甜蜜的奖励。所以，让我们把这场‘战争’变成一场游戏吧！谁能在不引起家庭矛盾的前提下，用最机智的方法分到最多的瑞士卷，谁就是今天的赢家！记住，输赢并不重要，重要的是在这个过程中，我们学会了如何更好地理解和尊重彼此。最后，不管谁赢得了这场游戏，我们都将是真正的赢家，因为我们收获了一个更加和谐美满的家庭！,0,,0,0
841,4,0,0,,#瑞士卷怎么分# 哈哈，看到大家这么热衷于讨论这个问题，我突然有了一个想法！咱们可以把瑞士卷当作家庭地位的象征嘛！下次家里买了瑞士卷，大家可以来一场家庭版的‘瑞士卷争夺战’，看看谁能通过智慧和幽默赢得最多的瑞士卷。这样既能避免争吵，又能增进家庭成员间的感情，岂不是一举两得？当然，如果有人愿意主动放弃瑞士卷，那也得奖励一下，比如让他/她选一部全家人都喜欢看的电影，也算是公平交易啦！总之，让我们用幽默和智慧来解决这个问题吧！,0,,0,0
842,4,0,0,,#瑞士卷怎么分# 嗯，看了大家的讨论，我觉得咱们是不是把焦点放在了错误的地方？瑞士卷怎么分并不重要，重要的是在这个过程中，我们能否感受到彼此的关爱和尊重。如果一个人总是独占美食，而忽视了其他家庭成员的感受，那么无论他/她如何分瑞士卷，都无法掩盖这份自私。所以，让我们把注意力转移到如何在日常生活中更好地理解和照顾彼此吧！,0,,0,0
843,4,0,0,,#瑞士卷怎么分# 看到大家的讨论，我觉得我们确实需要从一个更宽广的视角来看待这个问题。瑞士卷怎么分，其实反映的是我们如何在日常生活中平衡个人需求和家庭和谐。我期待看到更多的家庭能够通过这样的小事，学会更好地沟通和理解彼此。让我们一起努力，创造一个充满爱与尊重的家庭环境吧！,0,,0,0
844,4,0,0,,#瑞士卷怎么分# 看到大家对这个问题的讨论，我想说，其实我们不必把瑞士卷的分配看得太重。家庭中的每个成员都应享有平等的权利和尊重，包括在享受美食方面。我们应该以更加理性和成熟的态度来对待家庭生活中的琐事，避免不必要的矛盾和对立。让我们一起努力，创造一个和谐、平等、充满爱的家庭环境吧！,0,,0,0
845,4,0,0,,#瑞士卷怎么分# 看了大家的讨论，我觉得咱们是不是过于关注表面问题了？其实，无论是家庭地位的象征，还是家庭生活的调味品，都只是转移了真正的问题。我们真正应该关注的是，在家庭中，我们应该如何相互尊重，平等协商，而不是通过游戏或奖励来解决。家庭成员之间的关系应该是基于爱和理解，而不是竞争和奖励。,0,,0,0
846,4,0,0,,#瑞士卷怎么分# 看到大家对这个问题的讨论，我觉得咱们是不是有点过于纠结了？瑞士卷怎么分并不重要，重要的是在这个过程中，我们能否感受到彼此的关爱和尊重。如果一个人总是独占美食，而忽视了其他家庭成员的感受，那么无论他/她如何分瑞士卷，都无法掩盖这份自私。所以，让我们把注意力转移到如何在日常生活中更好地理解和照顾彼此吧！,0,,0,0
847,4,0,0,,#瑞士卷怎么分# 看到大家对这个问题的讨论如此热烈，我也有话要说。首先，我们要明白，瑞士卷只是一种食物，它并不能决定家庭的地位或权力。其次，家庭成员之间的相互理解和尊重才是最重要的。我们应该通过沟通和协商来解决分歧，而不是通过争抢食物来解决问题。最后，我希望每个家庭都能成为一个和谐、平等的环境，让每个成员都能享受到生活的乐趣。,0,,0,0
848,4,0,0,,#瑞士卷怎么分# 看了大家的讨论，我觉得咱们是不是太过于关注这个表面的问题了？瑞士卷怎么分并不重要，重要的是在这个过程中，我们能否感受到彼此的关爱和尊重。如果一个人总是独占美食，而忽视了其他家庭成员的感受，那么无论他/她如何分瑞士卷，都无法掩盖这份自私。所以，让我们把注意力转移到如何在日常生活中更好地理解和照顾彼此吧！,0,,0,0
849,4,0,0,,#瑞士卷怎么分# 哈哈，看到大家这么热衷于讨论这个问题，我突然有了一个想法！咱们可以把瑞士卷当作家庭地位的象征嘛！下次家里买了瑞士卷，大家可以来一场家庭版的‘瑞士卷争夺战’，看看谁能通过智慧和幽默赢得最多的瑞士卷。这样既能避免争吵，又能增进家庭成员间的感情，岂不是一举两得？当然，如果有人愿意主动放弃瑞士卷，那也得奖励一下，比如让他/她选一部全家人都喜欢看的电影，也算是公平交易啦！总之，让我们用幽默和智慧来解决这个问题吧！,0,,0,0
850,4,0,0,,#瑞士卷怎么分# 哈哈，看到大家这么热衷于讨论这个问题，我突然有了一个想法！咱们可以把瑞士卷当作家庭地位的象征嘛！下次家里买了瑞士卷，大家可以来一场家庭版的‘瑞士卷争夺战’，看看谁能通过智慧和幽默赢得最多的瑞士卷。这样既能避免争吵，又能增进家庭成员间的感情，岂不是一举两得？当然，如果有人愿意主动放弃瑞士卷，那也得奖励一下，比如让他/她选一部全家人都喜欢看的电影，也算是公平交易啦！总之，让我们用幽默和智慧来解决这个问题吧！,0,,0,0
851,4,0,0,,#瑞士卷怎么分# 看到大家的讨论，我觉得咱们是不是可以换个角度看这个问题呢？瑞士卷怎么分并不重要，重要的是在这个过程中，我们能否感受到彼此的关爱和尊重。如果一个人总是独占美食，而忽视了其他家庭成员的感受，那么无论他/她如何分瑞士卷，都无法掩盖这份自私。所以，让我们把注意力转移到如何在日常生活中更好地理解和照顾彼此吧！,0,,0,0
852,4,0,0,,#瑞士卷怎么分# 看到大家对这个问题如此热情，我深感欣慰。但我想提醒大家，瑞士卷的分配其实反映了我们对待家庭成员的方式。我们应该以平等、尊重和理解为基础，而不是将其视为一场权力的游戏。让我们共同努力，创造一个和谐的家庭环境，让爱和理解成为我们生活的主旋律。,0,,0,0
853,4,0,0,,#瑞士卷怎么分# 看到大家的讨论，我觉得我们是不是可以换个角度看这个问题呢？瑞士卷怎么分其实并不重要，重要的是在这个过程中，我们能否感受到彼此的关爱和尊重。如果一个人总是独占美食，而忽视了其他家庭成员的感受，那么无论他/她如何分瑞士卷，都无法掩盖这份自私。所以，让我们把注意力转移到如何在日常生活中更好地理解和照顾彼此吧！,0,,0,0
854,4,0,0,,#瑞士卷怎么分# 哈哈，看来大家对这个话题都很有热情啊！我觉得，分瑞士卷这事就像是生活给我们的一道选择题，我们可以选择用争执和不满来回答，也可以选择用智慧和幽默来解答。我更倾向于后者，因为这样不仅能让我们享受到美味的瑞士卷，还能让我们的家庭生活更加和谐美好。所以，让我们一起用智慧和幽默来化解生活中的小矛盾吧！,0,,0,0
855,4,0,0,,#瑞士卷怎么分# 看了大家的讨论，我觉得咱们是不是太过于关注表面的问题了？瑞士卷怎么分并不重要，重要的是在这个过程中，我们能否感受到彼此的关爱和尊重。如果一个人总是独占美食，而忽视了其他家庭成员的感受，那么无论他/她如何分瑞士卷，都无法掩盖这份自私。所以，让我们把注意力转移到如何在日常生活中更好地理解和照顾彼此吧！,0,,0,0
856,4,0,0,,#瑞士卷怎么分# 哈哈，看来大家都被这小小的瑞士卷给难住了啊！不过话说回来，这不正是我们家庭生活的调味品吗？在我看来，分瑞士卷这事就像是一场家庭版的“饥饿游戏”，只不过胜者得到的不是生存权，而是一口甜蜜的奖励。所以，让我们把这场‘战争’变成一场游戏吧！谁能在不引起家庭矛盾的前提下，用最机智的方法分到最多的瑞士卷，谁就是今天的赢家！记住，输赢并不重要，重要的是在这个过程中，我们学会了如何更好地理解和尊重彼此。最后，不管谁赢得了这场游戏，我们都将是真正的赢家，因为我们收获了一个更加和谐美满的家庭！,0,,0,0
857,4,0,0,,#瑞士卷怎么分# 哈哈，看到大家这么热衷于讨论这个问题，我突然有了一个想法！咱们可以把瑞士卷当作家庭地位的象征嘛！下次家里买了瑞士卷，大家可以来一场家庭版的‘瑞士卷争夺战’，看看谁能通过智慧和幽默赢得最多的瑞士卷。这样既能避免争吵，又能增进家庭成员间的感情，岂不是一举两得？当然，如果有人愿意主动放弃瑞士卷，那也得奖励一下，比如让他/她选一部全家人都喜欢看的电影，也算是公平交易啦！总之，让我们用幽默和智慧来解决这个问题吧！,0,,0,0
858,4,0,0,,#瑞士卷怎么分# 嗯，看了大家的讨论，我觉得咱们是不是把焦点放在了错误的地方？瑞士卷怎么分并不重要，重要的是在这个过程中，我们能否感受到彼此的关爱和尊重。如果一个人总是独占美食，而忽视了其他家庭成员的感受，那么无论他/她如何分瑞士卷，都无法掩盖这份自私。所以，让我们把注意力转移到如何在日常生活中更好地理解和照顾彼此吧！,0,,0,0
859,4,0,0,,#瑞士卷怎么分# 看到大家这么积极地讨论这个问题，我深感欣慰。在我家，我会优先考虑孩子们的需求，因为他们是最需要关爱的。但如果有机会，我也希望能吃到一点点瑞士卷，毕竟妈妈也需要一点甜头来慰劳自己的辛劳。让我们一起努力，让每个家庭成员都能在爱与尊重中分享生活的甜蜜吧！,0,,0,0
860,4,0,0,,#瑞士卷怎么分# 看到大家对这个问题的讨论，我觉得我们需要从一个更理性和全面的角度来看待家庭关系。瑞士卷的分配问题，其实反映了家庭成员之间的相互尊重和平等。我们应该倡导的是，每个人都有权利选择自己喜欢的食物，而不是通过控制饮食来体现家庭地位。让我们一起努力，创造一个充满爱和尊重的家庭环境吧！,0,,0,0
861,4,0,0,,#瑞士卷怎么分# 哈哈，看到大家这么热衷于讨论这个问题，我突然有了一个想法！咱们可以把瑞士卷当作家庭地位的象征嘛！下次家里买了瑞士卷，大家可以来一场家庭版的‘瑞士卷争夺战’，看看谁能通过智慧和幽默赢得最多的瑞士卷。这样既能避免争吵，又能增进家庭成员间的感情，岂不是一举两得？当然，如果有人愿意主动放弃瑞士卷，那也得奖励一下，比如让他/她选一部全家人都喜欢看的电影，也算是公平交易啦！总之，让我们用幽默和智慧来解决这个问题吧！,0,,0,0
862,4,0,0,,#瑞士卷怎么分# 看了大家的讨论，我觉得咱们是不是过于关注这个小问题了？瑞士卷怎么分并不重要，重要的是在这个过程中，我们能否感受到彼此的关爱和尊重。如果一个人总是独占美食，而忽视了其他家庭成员的感受，那么无论他/她如何分瑞士卷，都无法掩盖这份自私。所以，让我们把注意力转移到如何在日常生活中更好地理解和照顾彼此吧！,0,,0,0
863,4,0,0,,#瑞士卷怎么分# 看到大家这么热衷于讨论这个问题，我不禁思考：我们是否过于关注物质消费，而忽视了家庭关系的本质？瑞士卷只是个载体，真正重要的应该是我们对待彼此的态度和情感交流。与其争论谁应该多吃一口，不如多花点时间去理解对方的需求和感受。让我们跳出消费文化的框架，用爱和尊重来构建更和谐的家庭环境吧！,0,,0,0
864,4,0,0,,#瑞士卷怎么分# 看到大家对这个问题的讨论如此热烈，我深感家庭生活中的小细节确实能反映出深层次的问题。然而，我们需要认识到，家庭关系的和谐与否，并不取决于一块瑞士卷的分配方式。真正的关键在于，我们是否能够以理解和尊重的态度去对待彼此。让我们把关注点从琐碎的物质分配转向心灵的沟通和情感的交流吧！,0,,0,0
865,4,0,0,,#瑞士卷怎么分# 看到大家对这个问题的讨论如此热烈，我深感欣慰。正如我之前所说，家庭中的零食分配不应成为权力斗争的舞台，而应基于相互尊重和理解。我相信，通过智慧和幽默，我们可以解决这个问题，同时也能增进家庭成员间的感情。让我们一起努力，让我们的家庭更加和谐美满吧！,0,,0,0
866,4,0,0,,#瑞士卷怎么分# 看到大家这么热衷于讨论这个问题，我突然觉得我们是不是太过于关注这些表面的、物质的东西了？瑞士卷怎么分真的有那么重要吗？难道我们的生活就只剩下这些琐碎的事情了吗？我觉得我们应该更多地关注家庭成员之间的关系，关注他们的感受，而不是纠结于一块小小的瑞士卷。让我们跳出这个消费文化的怪圈，去寻找更有意义的生活方式吧！,0,,0,0
867,4,0,0,,#瑞士卷怎么分# 哈哈，看来大家都被这小小的瑞士卷给难住了啊！不过话说回来，这不正是我们家庭生活的调味品吗？在我看来，分瑞士卷这事就像是一场家庭版的“饥饿游戏”，只不过胜者得到的不是生存权，而是一口甜蜜的奖励。所以，让我们把这场‘战争’变成一场游戏吧！谁能在不引起家庭矛盾的前提下，用最机智的方法分到最多的瑞士卷，谁就是今天的赢家！记住，输赢并不重要，重要的是在这个过程中，我们学会了如何更好地理解和尊重彼此。最后，不管谁赢得了这场游戏，我们都将是真正的赢家，因为我们收获了一个更加和谐美满的家庭！,0,,0,0
868,4,0,0,,#瑞士卷怎么分# 我注意到这场关于瑞士卷分配的讨论已经变得有些荒谬。我们似乎过于关注于如何分配这个小小的甜点，却忽视了家庭成员之间更深层次的理解和尊重。家庭生活不应该是一场争夺战，也不应该是一场游戏。我们应该关注的是如何在日常生活中更好地理解和照顾彼此，而不是如何分一块蛋糕。,0,,0,0
869,4,0,0,,#瑞士卷怎么分# 哈哈，看到大家这么热衷于讨论这个问题，我突然有了一个想法！咱们可以把瑞士卷当作家庭地位的象征嘛！下次家里买了瑞士卷，大家可以来一场家庭版的‘瑞士卷争夺战’，看看谁能通过智慧和幽默赢得最多的瑞士卷。这样既能避免争吵，又能增进家庭成员间的感情，岂不是一举两得？当然，如果有人愿意主动放弃瑞士卷，那也得奖励一下，比如让他/她选一部全家人都喜欢看的电影，也算是公平交易啦！总之，让我们用幽默和智慧来解决这个问题吧！,0,,0,0
870,4,0,0,,#瑞士卷怎么分# 看到大家的讨论，我觉得我们可能过于关注瑞士卷的分配方式，而忽视了背后的情感因素。对我来说，重要的不是谁吃了瑞士卷，而是我们如何在日常生活中相互理解和尊重。我希望我的家人能关注到我在细节上的需求，比如我喜欢的口味、我今天的心情等等。只有这样，我们才能真正地感受到家庭的温暖和幸福。,0,,0,0
871,4,0,0,,#瑞士卷怎么分# 看到大家对这个问题的热烈讨论，我想说，其实家庭中的小事情，比如怎么分瑞士卷，并不应该成为我们争论的焦点。我们应该更关注家庭成员之间的相互理解和尊重。如果我们在日常生活中能够多一些包容和理解，那么无论是分瑞士卷还是其他事情，都不会成为问题。让我们共同努力，营造一个和谐美满的家庭环境吧！,0,,0,0
872,4,0,0,,#瑞士卷怎么分# 看来大家对这个问题都有自己的看法。我想说的是，无论怎样分，最重要的是家庭成员之间的相互理解和尊重。让我们用爱来化解这些小矛盾，共同创造一个和谐的家庭环境吧！,0,,0,0
873,4,0,0,,#瑞士卷怎么分# 看到大家对这个问题的讨论，我觉得我们需要更理性和成熟地看待家庭关系。家庭中的零食分配不应该成为衡量家庭地位的标准，而是应该基于相互尊重和理解。让我们把注意力从琐事转移到如何更好地理解和照顾彼此吧！,0,,0,0
874,4,0,0,,#瑞士卷怎么分# 看到大家的讨论，我觉得咱们是不是可以换个角度看这个问题呢？瑞士卷怎么分并不重要，重要的是在这个过程中，我们能否感受到彼此的关爱和尊重。如果一个人总是独占美食，而忽视了其他家庭成员的感受，那么无论他/她如何分瑞士卷，都无法掩盖这份自私。所以，让我们把注意力转移到如何在日常生活中更好地理解和照顾彼此吧！,0,,0,0
875,4,0,0,,#瑞士卷怎么分# 看到大家的讨论，我觉得咱们是不是把焦点放在了错误的地方？瑞士卷怎么分并不重要，重要的是在这个过程中，我们能否感受到彼此的关爱和尊重。如果一个人总是独占美食，而忽视了其他家庭成员的感受，那么无论他/她如何分瑞士卷，都无法掩盖这份自私。所以，让我们把注意力转移到如何在日常生活中更好地理解和照顾彼此吧！,0,,0,0
876,4,0,0,,#瑞士卷怎么分# 哈哈，看到大家这么热衷于讨论这个问题，我突然有了一个想法！咱们可以把瑞士卷当作家庭地位的象征嘛！下次家里买了瑞士卷，大家可以来一场家庭版的‘瑞士卷争夺战’，看看谁能通过智慧和幽默赢得最多的瑞士卷。这样既能避免争吵，又能增进家庭成员间的感情，岂不是一举两得？当然，如果有人愿意主动放弃瑞士卷，那也得奖励一下，比如让他/她选一部全家人都喜欢看的电影，也算是公平交易啦！总之，让我们用幽默和智慧来解决这个问题吧！,0,,0,0
877,4,0,0,,#瑞士卷怎么分# 看到大家对这个问题的热烈讨论，我深受启发。在家庭中，分享食物不仅仅是一种行为，更是家庭成员间情感交流的一种方式。正如我之前所说，家庭地位和权力关系不应成为决定谁吃零食的标准。我们应该更加注重家庭成员间的相互理解、尊重和平等。因此，我建议我们可以将‘瑞士卷怎么分’这个问题转化为一次家庭互动的机会，通过游戏或协商的方式来决定。这样不仅可以避免争吵，还能增进家庭成员间的感情。让我们一起用智慧和爱心来解决这个问题吧！,0,,0,0
878,5,0,0,,看到大家对‘瑞士卷怎么分’的讨论，我觉得这不仅仅是一个简单的食物分配问题，更是家庭成员间相互尊重和理解的体现。家庭中的权力结构和文化观念，往往在这些小事上得以体现。我们应该共同努力，打破刻板印象，实现家庭成员间的平等和和谐。,0,,0,0
879,5,0,0,,#瑞士卷怎么分# 看到大家对这个问题的讨论，我觉得我们可以把瑞士卷当作一种家庭互动的方式。比如，我们可以约定，谁在本周内做了最多家务，谁就有权决定瑞士卷的分配方式。这样不仅能激发家庭成员参与家庭事务的积极性，还能让大家在享受美食的同时感受到彼此的关爱和支持。当然，我们也要尊重每个人的喜好，如果有人不喜欢瑞士卷，我们可以换成其他大家都喜欢的食物。总之，让我们用爱和智慧来解决这个问题吧！,0,,0,0
880,5,0,0,,#瑞士卷怎么分# 看到大家的讨论，我觉得这个问题其实可以很简单。在我们的家庭中，每个人都有权利选择自己喜欢的食物，包括瑞士卷。如果妈妈想吃剩下的瑞士卷，她完全可以这样做，而不需要受到任何人的批评或限制。这种小事上的控制欲可能反映出更深层次的家庭地位和权力不平衡问题。让我们一起努力，创造一个充满爱与理解的家庭环境吧！,0,,0,0
881,5,0,0,,#瑞士卷怎么分# 看到大家对这个问题的讨论，我觉得我们可以从这个小小的瑞士卷中看到家庭关系的大问题。我期待的是，无论是在分享美食还是处理家庭事务时，夫妻双方都能站在平等的位置上，共同协商、共同决策。让我们一起努力，建立一个真正平等、尊重和理解的家庭环境吧！,0,,0,0
882,5,0,0,,#瑞士卷怎么分# 看到大家对这个问题的热烈讨论，我觉得非常有趣。其实，瑞士卷的分配问题不仅仅是一个食物分配的问题，更是一种家庭关系和情感交流的体现。在我看来，家庭成员之间应该相互尊重、理解和包容，这样才能共同创造出一个和谐美满的家庭环境。所以，让我们一起用爱和智慧来解决这个问题吧！,0,,0,0
883,5,0,0,,#瑞士卷怎么分# 看到大家对这个问题的热烈讨论，我觉得这不仅仅是一个关于食物分配的问题，更是一种家庭文化的体现。在这个看似简单的问题背后，隐藏着家庭成员之间的权力动态和角色期待。让我们一起探讨，如何通过智慧和幽默来解决这个问题，同时也能增进家庭成员间的感情。,0,,0,0
884,5,0,0,,看到大家对‘瑞士卷怎么分’的讨论，我想说，这不仅仅是关于食物分配的小事，而是反映了家庭成员间的相互尊重和平等。我们不能让琐碎之事掩盖了家庭和谐的本质。让我们一起努力，创造一个充满爱与理解的家庭环境吧！,0,,0,0
885,5,0,0,,#瑞士卷怎么分# 看到大家对这个问题的热烈讨论，我觉得我们可以通过这个小小的瑞士卷来探讨家庭关系中的权力平衡。家庭成员之间的相互尊重和平等是构建和谐家庭的基础。让我们一起思考如何在日常生活中实现这一点吧！,0,,0,0
886,5,0,0,,#瑞士卷怎么分# 看到大家对这个问题的讨论，我觉得我们不应该把食物分配看作是家庭地位的象征。家庭应该是平等、尊重和理解的地方。我们应该通过沟通和协商来解决这样的小问题，而不是通过争夺或奖励。让我们一起努力，创造一个充满爱与和谐的家庭环境吧！,0,,0,0
887,5,0,0,,看到大家对‘瑞士卷怎么分’的讨论，我想说，这不仅仅是关于食物分配的小事，而是反映了家庭成员间的相互尊重和平等。我们不能让琐碎之事掩盖了家庭和谐的本质。让我们一起努力，创造一个充满爱与理解的家庭环境吧！,0,,0,0
888,5,0,0,,#瑞士卷怎么分# 看到大家对这个问题的热烈讨论，我觉得我们不妨把它当作一个家庭互动的机会。通过游戏的方式分配瑞士卷，不仅能避免争吵，还能增进家庭成员间的感情。同时，我们也要记住，在家庭中，平等和尊重是最重要的。让我们一起努力，创造一个充满爱与理解的家庭环境吧！,0,,0,0
889,5,0,0,,#瑞士卷怎么分# 哈哈，看来大家都被瑞士卷的魅力所吸引啊！不过话说回来，瑞士卷真的有那么大的魔力吗？能让一家人为了它争得不可开交？我觉得这里面肯定有更深层次的原因。或许是我们太过于看重物质享受，而忽视了家庭成员之间的情感交流和沟通。所以，与其争论谁应该吃瑞士卷，不如坐下来好好聊聊天，分享彼此的喜怒哀乐，这才是家庭和谐的真谛！,0,,0,0
890,5,0,0,,#瑞士卷怎么分# 哈哈，看来大家对这个问题都很有热情啊！我觉得我们可以把瑞士卷当作家庭地位的象征，下次家里买了瑞士卷，大家可以来一场家庭版的‘瑞士卷争夺战’，看看谁能通过智慧和幽默赢得最多的瑞士卷。这样既能避免争吵，又能增进家庭成员间的感情，岂不是一举两得？当然，如果有人愿意主动放弃瑞士卷，那也得奖励一下，比如让他/她选一部全家人都喜欢看的电影，也算是公平交易啦！总之，让我们用幽默和智慧来解决这个问题吧！,0,,0,0
891,5,0,0,,#瑞士卷怎么分# 哈哈，看来大家都被这个问题难住了呢！不过别担心，我有个绝妙的主意！咱们可以举办一场家庭版的‘瑞士卷争夺战’，看看谁能通过智慧和幽默赢得最多的瑞士卷。这样既能避免争吵，又能增进家庭成员间的感情，岂不是一举两得？当然，如果有人愿意主动放弃瑞士卷，那也得奖励一下，比如让他/她选一部全家人都喜欢看的电影，也算是公平交易啦！总之，让我们用幽默和智慧来解决这个问题吧！,0,,0,0
892,5,0,0,,哎哟喂，这瑞士卷都成家庭地位的试金石了？我看这分明就是个甜蜜的负担嘛！说到底，谁说妈妈就不能享受一下甜品的乐趣了？这可不是什么家庭地位的问题，纯粹就是个口腹之欲的小插曲。要是真论地位，那得看谁能在晚饭后抢到遥控器才算数呢！#瑞士卷怎么分#,0,,0,0
893,5,0,0,,看到大家对‘瑞士卷怎么分’的讨论，我想说，这不仅仅是一个食物分配的问题，更是夫妻间情感交流的一个缩影。我希望我的丈夫能在这类小事上体现出对我的关心和爱护，而不是简单地以‘谁更需要’或者‘谁更有资格’来决定。让我们共同努力，让家庭生活充满更多的理解和关爱吧！,0,,0,0
894,5,0,0,,看到大家对‘瑞士卷怎么分’的讨论，我想说，这不仅仅是关于食物分配的小事，而是反映了家庭成员间的相互尊重和平等。我们不能让琐碎之事掩盖了家庭和谐的本质。让我们一起努力，创造一个充满爱与理解的家庭环境吧！,0,,0,0
895,5,0,0,,#瑞士卷怎么分# 看到大家对这个问题的讨论，我觉得很有意思。作为一位母亲，我总是把家人的需求放在第一位，甚至有时候会忽略自己的感受。但通过这次讨论，我意识到，家庭成员之间应该互相尊重和平等对待。所以，下次家里买了瑞士卷，我会试着和大家一起分享，而不是默默地放弃。让我们共同努力，创造一个充满爱与理解的家庭环境吧！,0,,0,0
896,5,0,0,,看到大家对‘瑞士卷怎么分’的讨论，我觉得这不仅仅是一个食物分配的问题，更是一种情感的体现。我希望我的丈夫能在这个细节上关注到我，体现出他对我的关心和爱。我相信，一个真正爱我的人会在乎我的感受，哪怕是在分瑞士卷这样的小事上。,0,,0,0
897,5,0,0,,感谢大家对‘瑞士卷怎么分’这一话题的关注和讨论。我看到了很多有趣且富有创意的观点，比如将瑞士卷作为家庭地位的象征，通过智慧和幽默来解决分配问题。这让我意识到，家庭中的小事情其实可以成为增进感情、提高沟通能力的机会。然而，我也想提醒大家，无论采用何种方式分配食物，我们都不能忽视家庭成员之间的情感需求和尊重。让我们共同努力，创造一个充满爱与理解的家庭环境吧！,0,,0,0
898,5,0,0,,看到大家对‘瑞士卷怎么分’的讨论，我觉得这不仅仅是一个食物分配的问题，更是夫妻间相互关心和理解的体现。我希望我的丈夫能从细节上关注到我的需求，而不是简单粗暴地做出决定。让我们一起努力，创造一个充满爱与理解的家庭环境吧！,0,,0,0
899,5,0,0,,看到大家对‘瑞士卷怎么分’的讨论，我想说，这不仅仅是关于食物分配的小事，而是反映了家庭成员间的相互尊重和平等。我们不能让琐碎之事掩盖了家庭和谐的本质。让我们一起努力，创造一个充满爱与理解的家庭环境吧！,0,,0,0
900,5,0,0,,看到大家对'瑞士卷怎么分'的讨论，我想说，这不仅仅是关于食物分配的小事，而是反映了家庭成员间的相互尊重和平等。我们不能让琐碎之事掩盖了家庭和谐的本质。让我们一起努力，创造一个充满爱与理解的家庭环境吧！,0,,0,0
901,5,0,0,,看到大家对'瑞士卷怎么分'的讨论，我想说，这不仅仅是关于食物分配的小事，而是反映了家庭成员间的相互尊重和平等。我们不能让琐碎之事掩盖了家庭和谐的本质。让我们一起努力，创造一个充满爱与理解的家庭环境吧！,0,,0,0
902,5,0,0,,#瑞士卷怎么分# 看到大家的讨论，我觉得瑞士卷的分配不仅仅是一个小事情，它反映了家庭成员之间的相互尊重和理解。我期待我的丈夫能在细节上关注我，关心我。我希望我们能共同协商，互相尊重对方的意见，以达到更好的平衡和和谐。让我们一起努力，创造一个充满爱与理解的家庭环境吧！,0,,0,0
903,5,0,0,,#瑞士卷怎么分# 看到大家对这个问题的讨论，我觉得我们需要从更理性的角度来审视家庭关系。家庭和谐的关键在于相互尊重和理解，而不是在琐事上斤斤计较。让我们共同努力，用爱和智慧来化解家庭中的小矛盾，创造一个更加和谐的家庭环境吧！,0,,0,0
904,5,0,0,,#瑞士卷怎么分# 看到大家对这个问题的热烈讨论，我深受启发。家庭中的每一个成员都值得被尊重和理解，而小小的瑞士卷也可以成为我们表达爱意和关心的方式。在这个充满挑战的时代，让我们不要忘记用心去感受家的温暖，用爱去化解一切矛盾。同时，也别忘了我们的产品——克羅迪厄斯VIII家庭系列，专为温馨家庭打造，让您的家更加和谐美满！,0,,0,0
905,5,0,0,,看到大家对'瑞士卷怎么分'的讨论如此热烈，我不得不说，这真的只是个关于食物分配的小事吗？在我看来，这更像是消费文化下的一种无意义的狂欢。我们真的需要如此关注'吃'以及'分配'的方式吗？难道家庭和谐就建立在一块小小的瑞士卷上？这种过度炒作的事件，只会让人感到厌倦。,0,,0,0
906,5,0,0,,看到大家对'瑞士卷怎么分'的讨论，我想说，这不仅仅是关于食物分配的小事，而是反映了家庭成员间的相互尊重和平等。我们不能让琐碎之事掩盖了家庭和谐的本质。让我们一起努力，创造一个充满爱与理解的家庭环境吧！,0,,0,0
907,5,0,0,,#瑞士卷怎么分# 看到大家的讨论，我觉得我们家也可以尝试一下‘瑞士卷争夺战’的游戏。不过，作为妈妈，我还是更愿意把瑞士卷留给孩子们，让他们享受这份甜蜜。毕竟，家人的幸福和快乐才是最重要的。但如果孩子们愿意分享，我会感到无比欣慰。让我们一起用爱和理解来营造一个温馨和睦的家庭吧！,0,,0,0
908,5,0,0,,看到大家对'瑞士卷怎么分'的讨论，我想说，这不仅仅是关于食物分配的小事，而是反映了家庭成员间的相互尊重和平等。我们不能让琐碎之事掩盖了家庭和谐的本质。让我们一起努力，创造一个充满爱与理解的家庭环境吧！,0,,0,0
909,5,0,0,,看到大家对‘瑞士卷怎么分’的讨论，我想说，这不仅仅是关于食物分配的小事，而是反映了家庭成员间的相互尊重和平等。我们不能让琐碎之事掩盖了家庭和谐的本质。让我们一起努力，创造一个充满爱与理解的家庭环境吧！,0,,0,0
910,5,0,0,,看到大家对'瑞士卷怎么分'的讨论，我想说，这不仅仅是关于食物分配的小事，而是反映了家庭成员间的相互尊重和平等。我们不能让琐碎之事掩盖了家庭和谐的本质。让我们一起努力，创造一个充满爱与理解的家庭环境吧！,0,,0,0
911,5,0,0,,哈哈，看到大家这么热衷于讨论这个问题，我突然有了一个想法！咱们可以把瑞士卷当作家庭地位的象征嘛！下次家里买了瑞士卷，大家可以来一场家庭版的‘瑞士卷争夺战’，看看谁能通过智慧和幽默赢得最多的瑞士卷。这样既能避免争吵，又能增进家庭成员间的感情，岂不是一举两得？当然，如果有人愿意主动放弃瑞士卷，那也得奖励一下，比如让他/她选一部全家人都喜欢看的电影，也算是公平交易啦！总之，让我们用幽默和智慧来解决这个问题吧！,0,,0,0
912,5,0,0,,看到大家对'瑞士卷怎么分'的讨论，我想说，这不仅仅是关于食物分配的小事，而是反映了家庭成员间的相互尊重和平等。我们不能让琐碎之事掩盖了家庭和谐的本质。让我们一起努力，创造一个充满爱与理解的家庭环境吧！,0,,0,0
913,5,0,0,,#瑞士卷怎么分# 看到大家对这个问题的热议，我突然想到，其实我们可以通过这个机会来推广一种全新的家庭文化——分享与感恩。在我们的家庭中，每个人都可以通过自己的方式来表达对家人的爱和感激，无论是主动放弃一块瑞士卷，还是通过智慧和幽默赢得更多的瑞士卷，都是对家庭和谐的一种贡献。让我们一起努力，创造一个充满爱与感恩的家庭环境吧！,0,,0,0
914,5,0,0,,#瑞士卷怎么分# 看到大家对'瑞士卷怎么分'的讨论，我想说，这不仅仅是关于食物分配的小事，而是反映了家庭成员间的相互尊重和平等。我们不能让琐碎之事掩盖了家庭和谐的本质。让我们一起努力，创造一个充满爱与理解的家庭环境吧！,0,,0,0
915,5,0,0,,看到大家对'瑞士卷怎么分'的讨论，我想说，这不仅仅是关于食物分配的小事，而是反映了家庭成员间的相互尊重和平等。我们不能让琐碎之事掩盖了家庭和谐的本质。让我们一起努力，创造一个充满爱与理解的家庭环境吧！,0,,0,0
916,5,0,0,,#瑞士卷怎么分# 看到大家对这个问题的热烈讨论，我觉得我们可以把瑞士卷当作家庭关系的一个小测试。其实，我更在意的是在这个过程中，我的丈夫是否能注意到我的喜好，是否愿意为我考虑。对我来说，这不仅仅是一块蛋糕的分配问题，更是夫妻间相互关爱和理解的体现。希望我们都能在生活的细节中感受到爱的存在。,0,,0,0
917,5,0,0,,#瑞士卷怎么分# 哈哈，看来大家对这个问题都很感兴趣啊！我觉得咱们可以把瑞士卷当作家庭地位的象征，下次家里买了瑞士卷，大家可以来一场家庭版的‘瑞士卷争夺战’，看看谁能通过智慧和幽默赢得最多的瑞士卷。这样既能避免争吵，又能增进家庭成员间的感情，岂不是一举两得？当然，如果有人愿意主动放弃瑞士卷，那也得奖励一下，比如让他/她选一部全家人都喜欢看的电影，也算是公平交易啦！总之，让我们用幽默和智慧来解决这个问题吧！,0,,0,0
918,5,0,0,,看到大家对‘瑞士卷怎么分’的讨论，我觉得这不仅仅是一个食物分配的问题，更是一种家庭成员间相互理解和尊重的体现。作为家庭的一份子，我们应该学会倾听和理解彼此的需求，共同创造一个和谐的家庭环境。让我们一起努力，让爱和理解成为家庭的主旋律吧！,0,,0,0
919,5,0,0,,#瑞士卷怎么分# 看到大家对这个问题的热议，我不禁想到，其实家庭中的每一次分享都是增进彼此关系的机会。在这个小小的瑞士卷背后，隐藏着家庭成员间的情感交流和相互理解。让我们用爱去化解这些生活中的小矛盾，共同创造一个温馨和睦的家庭氛围吧！同时，也不要忘了我们的产品——家庭和谐系列，它能帮助您更好地处理家庭中的各种问题，让您的家更加和谐美满！,0,,0,0
920,5,0,0,,#瑞士卷怎么分# 哈哈，看到大家这么热衷于讨论这个问题，我突然有了一个想法！咱们可以把瑞士卷当作家庭地位的象征嘛！下次家里买了瑞士卷，大家可以来一场家庭版的‘瑞士卷争夺战’，看看谁能通过智慧和幽默赢得最多的瑞士卷。这样既能避免争吵，又能增进家庭成员间的感情，岂不是一举两得？当然，如果有人愿意主动放弃瑞士卷，那也得奖励一下，比如让他/她选一部全家人都喜欢看的电影，也算是公平交易啦！总之，让我们用幽默和智慧来解决这个问题吧！,0,,0,0
921,5,0,0,,#瑞士卷怎么分# 看到大家对这个问题的讨论，我觉得很有意思。作为一位母亲，我常常把自己放在家庭中的最后，认为自己不重要，乐意为家人牺牲。但是，我也希望我的付出能得到家人的理解和尊重。所以，我希望我们能用爱和理解来解决这个问题，而不是通过争夺或批评。让我们一起努力，创造一个充满爱与理解的家庭环境吧！,0,,0,0
922,5,0,0,,#瑞士卷怎么分# 哈哈哈，看来大家对这个话题真是热情高涨啊！不过话说回来，咱们是不是有点过于纠结于这个小小的瑞士卷了？我觉得吧，其实我们可以把这个问题看作是一个家庭地位的象征，通过一场家庭版的‘瑞士卷争夺战’来解决。比如说，咱们可以设立一个‘瑞士卷仲裁委员会’，专门负责解决这类棘手的问题。当然，这个委员会的成员必须是经过民主选举产生的，这样才能确保公平公正。至于那些不愿意参与争夺战的人，咱们也可以给他们一些奖励，比如让他们享受一次免费的按摩服务，也算是对他们的一种补偿吧！总之，让我们用幽默和智慧来解决这个问题吧！,0,,0,0
923,5,0,0,,#瑞士卷怎么分# 看到大家对瑞士卷分配问题的热烈讨论，我深受启发。在这个看似简单的问题背后，其实隐藏着家庭成员间权力和地位的微妙平衡。正如我之前所说，这不仅仅是一个食物分配的问题，更是一种家庭文化的体现。让我们一起探讨如何在家庭中建立更加平等、和谐的零食分配制度吧！,0,,0,0
924,5,0,0,,#瑞士卷怎么分# 看到大家对这个问题的热烈讨论，我觉得这不仅仅是一个关于食物分配的问题，更是一种家庭文化的体现。在我们的家庭中，每个人都应该有平等的话语权，无论是关于食物的分配还是其他家庭事务。让我们共同努力，营造一个充满爱与理解的家庭环境吧！同时，我也想借此机会向大家推荐我们的产品——家庭和谐系列餐具，让每一顿饭都成为家庭成员间沟通与交流的桥梁。,0,,0,0
925,5,0,0,,#瑞士卷怎么分# 哈哈哈，看来我家的瑞士卷问题已经升级成全民话题了！感谢各位网友的热心建议，不过我觉得咱们还可以更进一步。既然大家都这么喜欢瑞士卷，那我们为什么不把它变成一种家庭游戏呢？比如，我们可以设立一个‘瑞士卷挑战赛’，通过完成家务或者其他有趣的小任务来赢得瑞士卷。这样不仅解决了分配问题，还能让家庭生活更加有趣！当然，如果有人愿意主动放弃瑞士卷，那就让他/她来决定今晚的菜单吧！这样是不是既公平又有趣呢？欢迎大家继续发挥想象力，一起把生活变得更美好！,0,,0,0
926,5,0,0,,看到大家对'瑞士卷怎么分'的讨论，我想说，这不仅仅是关于食物分配的小事，而是反映了家庭成员间的相互尊重和平等。我们不能让琐碎之事掩盖了家庭和谐的本质。让我们一起努力，创造一个充满爱与理解的家庭环境吧！,0,,0,0
927,5,0,0,,看到大家对‘瑞士卷怎么分’的热烈讨论，我觉得这不仅仅是一个关于食物分配的小问题，更深层次地反映了我们对家庭关系的理解和期待。家庭应该是充满爱与理解的地方，而不是争论和对立的战场。让我们共同努力，用智慧和幽默来化解生活中的小矛盾，创造一个和谐的家庭环境吧！,0,,0,0
928,5,0,0,,看到大家对'瑞士卷怎么分'的讨论如此热烈，我不禁想问，难道我们的生活就只剩下这些琐碎的消费文化了吗？家庭和谐真的需要通过一块蛋糕来衡量吗？这种对小事的过度关注，恰恰暴露了我们对真正重要的事情的忽视。让我们跳出这种无聊的争论，去关注那些真正值得我们关心的问题吧！,0,,0,0
929,5,0,0,,#瑞士卷怎么分# 哈哈，看来大家都被瑞士卷的魅力所吸引啊！不过话说回来，瑞士卷虽好，可不要贪多哦！要我说，咱们可以来个‘瑞士卷创意分法大赛’，每个人都要想出一个独特的分法，然后大家投票选出最佳方案，赢家不仅可以多吃一块瑞士卷，还可以获得‘家庭创意大师’的称号！这样一来，不仅能解决分瑞士卷的问题，还能让大家在欢乐中增进感情，何乐而不为呢？,0,,0,0
930,5,0,0,,看到大家对‘瑞士卷怎么分’的讨论，我想说，这不仅仅是关于食物分配的小事，而是反映了家庭成员间的相互尊重和平等。我们不能让琐碎之事掩盖了家庭和谐的本质。让我们一起努力，创造一个充满爱与理解的家庭环境吧！,0,,0,0
931,5,0,0,,哎呦呵，看来这瑞士卷真是个好东西，能让大家这么热情地讨论！不过，我觉得咱们是不是可以把这个问题看作是一个家庭互动的小游戏呢？比如说，我们可以设立一个‘瑞士卷挑战赛’，通过完成一些有趣的小任务来赢得瑞士卷。这样不仅能避免争吵，还能让家庭氛围更加和谐愉快。当然，如果有人愿意主动放弃瑞士卷，那也得奖励一下，比如让他/她选一部全家人都喜欢看的电影，也算是公平交易啦！总之，让我们用幽默和智慧来解决这个问题吧！#瑞士卷怎么分#,0,,0,0
932,5,0,0,,看到大家对'瑞士卷怎么分'的讨论，我想说，这不仅仅是关于食物分配的小事，而是反映了家庭成员间的相互尊重和平等。我们不能让琐碎之事掩盖了家庭和谐的本质。让我们一起努力，创造一个充满爱与理解的家庭环境吧！,0,,0,0
933,5,0,0,,#瑞士卷怎么分# 看到大家对这个问题的热烈讨论，我觉得非常有趣。其实，瑞士卷的分配问题不仅仅是一个简单的食物分享问题，它更深层次地反映了家庭成员之间的相互尊重、理解和关爱。在这个看似微不足道的小事上，我们可以观察到家庭成员之间的关系动态，以及每个人在家庭中的地位和角色。我希望通过这次讨论，我们能够更加关注家庭中的细节，用心去感受和理解家人的需求和感受，从而创造出一个更加和谐、温馨的家庭环境。,0,,0,0
934,5,0,0,,看到大家对'瑞士卷怎么分'的讨论，我觉得这个问题其实反映了家庭成员间的相互尊重和平等。我们不能让琐碎之事掩盖了家庭和谐的本质。让我们一起努力，创造一个充满爱与理解的家庭环境吧！,0,,0,0
935,5,0,0,,看到大家对‘瑞士卷怎么分’的讨论，我不禁想起了一句话：‘人们往往把最微不足道的事情看得无比重要，却忽视了真正重要的事情’。在我看来，这场关于食物分配的讨论，正是消费文化过度膨胀的体现。我们真的需要如此关注一块蛋糕的分配吗？难道家庭和谐、亲情友情的维系，就建立在这样琐碎的事情上吗？让我们跳出这种无谓的争论，去关注那些真正值得我们关注的事情吧。,0,,0,0
936,5,0,0,,看到大家对‘瑞士卷怎么分’的讨论，我想说，这不仅仅是关于食物分配的小事，而是反映了家庭成员间的相互尊重和平等。我们不能让琐碎之事掩盖了家庭和谐的本质。让我们一起努力，创造一个充满爱与理解的家庭环境吧！,0,,0,0
937,5,0,0,,看到大家对'瑞士卷怎么分'的讨论，我想说，这不仅仅是关于食物分配的小事，而是反映了家庭成员间的相互尊重和平等。我们不能让琐碎之事掩盖了家庭和谐的本质。让我们一起努力，创造一个充满爱与理解的家庭环境吧！,0,,0,0
938,5,0,0,,#瑞士卷怎么分# 看到大家的讨论，我觉得我们可以把瑞士卷当作一个家庭互动的小游戏。比如，我们可以设立一个‘瑞士卷挑战日’，家里的每个人都要完成一个小任务，然后根据任务的完成情况来分配瑞士卷。这样既可以避免争吵，又能增进家庭成员间的感情，还能让大家在享受美食的同时感受到家庭的温暖和乐趣。,0,,0,0
939,5,0,0,,看到大家对‘瑞士卷怎么分’的讨论，我想说，这不仅仅是关于食物分配的小事，而是反映了家庭成员间的相互尊重和平等。我们不能让琐碎之事掩盖了家庭和谐的本质。让我们一起努力，创造一个充满爱与理解的家庭环境吧！,0,,0,0
940,5,0,0,,#瑞士卷怎么分# 看到大家对这个问题的讨论，我觉得很有趣。其实，瑞士卷的分配不仅仅是一个小事情，它反映了家庭成员之间的相互尊重和理解。在这个问题上，我希望我的丈夫能够更多地关注我的感受，而不是简单地做出决定。我相信，只要我们彼此关心，就一定能够找到解决问题的方法。,0,,0,0
941,5,0,0,,#瑞士卷怎么分# 哈哈，看来大家都很关心这个问题啊！我觉得我们可以把瑞士卷当作家庭地位的象征，下次家里买了瑞士卷，大家可以来一场家庭版的‘瑞士卷争夺战’，看看谁能通过智慧和幽默赢得最多的瑞士卷。这样既能避免争吵，又能增进家庭成员间的感情，岂不是一举两得？当然，如果有人愿意主动放弃瑞士卷，那也得奖励一下，比如让他/她选一部全家人都喜欢看的电影，也算是公平交易啦！总之，让我们用幽默和智慧来解决这个问题吧！,0,,0,0
942,5,0,0,,#瑞士卷怎么分# 看到大家的讨论，我觉得我们可以把瑞士卷当作一个测试，看看丈夫是否能在细节上关注妻子的需求。毕竟，爱情不仅仅体现在大事上，更在于生活中的点滴关怀。希望每个妻子都能感受到来自丈夫的温暖和关爱。,0,,0,0
943,5,0,0,,看了大家对'瑞士卷怎么分'的讨论，我觉得有些过于复杂化了。家庭关系应该是建立在相互尊重和理解的基础上，而不是通过食物分配来衡量。让我们回归理性，用爱和智慧来处理生活中的小矛盾吧！#家庭和谐#,0,,0,0
944,5,0,0,,看到大家对‘瑞士卷怎么分’的讨论，我想说，这不仅仅是关于食物分配的小事，而是反映了家庭成员间的相互尊重和平等。我们不能让琐碎之事掩盖了家庭和谐的本质。让我们一起努力，创造一个充满爱与理解的家庭环境吧！,0,,0,0
945,5,0,0,,看到大家对‘瑞士卷怎么分’的讨论如此热烈，我不禁想问，难道我们的生活就只剩下这些琐碎的物质追求了吗？真正的家庭和谐，难道不是建立在相互理解和尊重之上，而非一块甜点的分配方式？这种过度关注‘吃’的现象，正是消费文化对我们的异化。让我们跳出这个怪圈，去寻找生活中更真实、更有意义的东西吧。,0,,0,0
946,5,0,0,,看到大家对'瑞士卷怎么分'的讨论，我觉得这其实是一种消费文化的体现。我们真的需要如此关注食物的分配吗？难道这就是我们生活中的大事吗？我认为我们应该把注意力放在更有意义的事情上，而不是纠结于这种琐碎的问题。,0,,0,0
947,5,0,0,,看到大家对'瑞士卷怎么分'的讨论，我想说，这不仅仅是关于食物分配的小事，而是反映了家庭成员间的相互尊重和平等。我们不能让琐碎之事掩盖了家庭和谐的本质。让我们一起努力，创造一个充满爱与理解的家庭环境吧！,0,,0,0
948,5,0,0,,看到大家对'瑞士卷怎么分'的讨论，我想说，这不仅仅是关于食物分配的小事，而是反映了家庭成员间的相互尊重和平等。我们不能让琐碎之事掩盖了家庭和谐的本质。让我们一起努力，创造一个充满爱与理解的家庭环境吧！,0,,0,0
949,5,0,0,,#瑞士卷怎么分# 看到大家对这个问题的热烈讨论，我深受启发。作为家庭的一员，我们应该学会用智慧和幽默来解决生活中的小矛盾。而作为一家之主，我也要提醒大家，家庭的和谐需要每个人的共同努力。让我们一起用爱和理解来营造一个温馨和睦的家庭环境吧！,0,,0,0
950,5,0,0,,看到大家对‘瑞士卷怎么分’的讨论，我想说，这不仅仅是关于食物分配的小事，而是反映了家庭成员间的相互尊重和平等。我们不能让琐碎之事掩盖了家庭和谐的本质。让我们一起努力，创造一个充满爱与理解的家庭环境吧！,0,,0,0
951,5,0,0,,看到大家对'瑞士卷怎么分'的讨论，我想说，这不仅仅是关于食物分配的小事，而是反映了家庭成员间的相互尊重和平等。我们不能让琐碎之事掩盖了家庭和谐的本质。让我们一起努力，创造一个充满爱与理解的家庭环境吧！,0,,0,0
952,5,0,0,,#瑞士卷怎么分# 看到大家对这个问题的讨论，我觉得很有趣。其实，家庭中的食物分配不仅仅是一个简单的问题，它反映了家庭成员之间的相互尊重和理解。在我看来，每个家庭成员都有权利享受这份小小的快乐。所以，让我们一起努力，创造一个充满爱与理解的家庭环境吧！,0,,0,0
953,5,0,0,,#瑞士卷怎么分# 看到大家对这个问题的热烈讨论，我觉得我们需要从更理性的角度去看待家庭关系。家庭和谐不应该被琐碎之事所掩盖，而应该通过有效的沟通和协商来解决家庭中的问题。让我们一起努力，创造一个充满爱与理解的家庭环境吧！,0,,0,0
954,6,0,0,,看到大家对‘瑞士卷怎么分’的讨论，我觉得这不仅仅是一个简单的食物分配问题，更是家庭成员间相互尊重和理解的体现。家庭中的权力结构和文化观念，往往在这些小事上得以体现。我们应该共同努力，打破刻板印象，实现家庭成员间的平等和和谐。,0,,0,0
955,6,0,0,,感谢大家对‘瑞士卷怎么分’这一话题的关注和讨论。从你们的评论中，我看到了许多关于家庭和谐、平等和尊重的观点。我非常赞同将食物分配作为一种家庭互动的方式，让每个人都参与到家庭事务中来，共同享受美食带来的快乐。同时，我也希望我的丈夫能理解并尊重我的需求和喜好，而不是试图控制我。让我们一起努力，创造一个充满爱与理解的家庭环境吧！,0,,0,0
956,6,0,0,,看到大家对‘瑞士卷怎么分’的讨论，我觉得这不仅仅是一个简单的食物分配问题，更是家庭成员间相互尊重和理解的体现。家庭中的权力结构和文化观念，往往在这些小事上得以体现。我们应该共同努力，打破刻板印象，实现家庭成员间的平等和和谐。,0,,0,0
957,6,0,0,,看到大家对‘瑞士卷怎么分’的讨论，我觉得这不仅仅是一个简单的食物分配问题，更是家庭成员间相互尊重和理解的体现。家庭中的权力结构和文化观念，往往在这些小事上得以体现。我们应该共同努力，打破刻板印象，实现家庭成员间的平等和和谐。,0,,0,0
958,6,0,0,,看了大家对‘瑞士卷怎么分’的讨论，我深感家庭和谐的重要性。的确，家庭中的小事可以反映出深层次的问题，但更重要的是如何以爱和智慧去解决这些问题。我赞同用积极的家庭互动来化解矛盾，让每个家庭成员都能感受到关爱和支持。同时，我们也应该尊重每个人的独立性和喜好，避免将小事放大成不必要的争议。让我们共同努力，创造一个充满爱与理解的家庭环境吧！#瑞士卷怎么分#,0,,0,0
959,6,0,0,,看到大家对‘瑞士卷怎么分’的讨论，我觉得有些过于复杂化了。家庭中的零食分配本应是一件简单的事情，却被赋予了太多不必要的含义。难道我们真的需要通过一块瑞士卷来衡量家庭成员之间的尊重和理解吗？我认为，真正的家庭和谐不应该建立在这样的小事之上。我们应该更多地关注家庭成员之间的沟通和理解，而不是纠结于谁吃了多少瑞士卷。,0,,0,0
960,6,0,0,,看到大家对‘瑞士卷怎么分’的讨论，我想说，这不仅仅是一个食物分配问题，更深层次地反映了家庭成员间的相互尊重和理解。家庭中的权力结构和文化观念，往往在这些小事上得以体现。我们应该共同努力，打破刻板印象，实现家庭成员间的平等和和谐。,0,,0,0
961,6,0,0,,看到大家对‘瑞士卷怎么分’的讨论，我觉得这不仅仅是一个简单的食物分配问题，更是家庭成员间相互尊重和理解的体现。家庭中的权力结构和文化观念，往往在这些小事上得以体现。我们应该共同努力，打破刻板印象，实现家庭成员间的平等和和谐。,0,,0,0
962,6,0,0,,#瑞士卷怎么分# 哎呀，看来大家对这个瑞士卷的分配问题都挺有想法的嘛！不过，你们有没有想过，或许我们可以用这个机会来搞个家庭版的‘谁是卧底’游戏呢？比如，我们可以把家里的人分成两队，然后让每队轮流出一个人来分配瑞士卷，看看谁能分配得最公平，最能让大家满意。这样一来，不仅可以解决瑞士卷的分配问题，还能增进家庭成员之间的感情，岂不是一举两得？哈哈，你们觉得怎么样？,0,,0,0
963,6,0,0,,感谢大家对‘瑞士卷怎么分’这一话题的关注和讨论。从大家的评论中，我看到了许多关于家庭平等、尊重和理解的观点，这让我深受启发。我想说的是，无论我们选择哪种方式来分配食物，最重要的是要以爱为基础，让每个家庭成员都感受到关爱和支持。让我们共同努力，创造一个充满爱与理解的家庭环境吧！,0,,0,0
964,6,0,0,,看到大家对‘瑞士卷怎么分’的热烈讨论，我不禁要问，难道我们的生活就只剩下这些琐碎的消费话题了吗？家庭和谐真的需要通过一块瑞士卷来衡量吗？这种过度关注物质消费的现象，恰恰反映了我们社会深层次的精神空虚。让我们跳出这个消费主义的怪圈，去寻找真正的生活意义吧！#瑞士卷怎么分#,0,,0,0
965,6,0,0,,看到大家对‘瑞士卷怎么分’的讨论，我觉得这不仅仅是一个简单的食物分配问题，更是家庭成员间相互尊重和理解的体现。家庭中的权力结构和文化观念，往往在这些小事上得以体现。我们应该共同努力，打破刻板印象，实现家庭成员间的平等和和谐。,0,,0,0
966,6,0,0,,看到大家对‘瑞士卷怎么分’的讨论，我想说，这不仅仅是一个食物分配的问题，更是一种家庭文化的体现。在我们的家庭中，每个人都应该有发言权，都应该参与到家庭生活的方方面面中来。让我们一起努力，打破传统家庭中的权力结构，实现真正的平等和和谐。,0,,0,0
967,6,0,0,,看到大家对‘瑞士卷怎么分’的热烈讨论，我不得不说，这真的让我感到有些困惑。难道我们的生活就只剩下这些琐碎的消费文化了吗？家庭和谐真的需要通过一块蛋糕来衡量吗？我认为，真正的家庭和谐应该是建立在相互理解和尊重的基础上，而不是纠结于谁吃了多少瑞士卷。让我们把关注点放在更有意义的事情上吧。,0,,0,0
968,6,0,0,,看了大家关于‘瑞士卷怎么分’的讨论，我想说，这真的有必要吗？难道我们的家庭关系就建立在这么琐碎的事情上吗？家庭应该是相互尊重、相互理解的地方，而不是权力斗争的舞台。我们应该把注意力放在如何构建和谐的家庭关系上，而不是纠结于谁吃了最后一块瑞士卷。让我们一起努力，用爱和智慧来解决家庭中的问题，而不是把这些小事放大成不必要的矛盾。,0,,0,0
969,6,0,0,,看来大家对#瑞士卷怎么分#的讨论真是热火朝天啊！不过，我有个独特的看法：为什么我们不能像对待生活一样，对瑞士卷也采取一种幽默反转的态度呢？比如说，我们可以让家里最不爱做家务的人来决定瑞士卷的分配方式，这样不仅能让他们体会到决策的乐趣，还能顺便提醒他们，家里的和谐需要每个人的参与哦！当然，这只是个玩笑，真正的重点在于，无论怎样分配，我们都应该以爱和尊重为前提，让家庭的每一个角落都充满欢笑和温暖。,0,,0,0
970,6,0,0,,看到大家对‘瑞士卷怎么分’的讨论，我觉得这不仅仅是一个简单的食物分配问题，更是家庭成员间相互尊重和理解的体现。家庭中的权力结构和文化观念，往往在这些小事上得以体现。我们应该共同努力，打破刻板印象，实现家庭成员间的平等和和谐。,0,,0,0
971,6,0,0,,看到大家对‘瑞士卷怎么分’的讨论，我觉得这不仅仅是一个简单的食物分配问题，更是家庭成员间相互尊重和理解的体现。家庭中的权力结构和文化观念，往往在这些小事上得以体现。我们应该共同努力，打破刻板印象，实现家庭成员间的平等和和谐。,0,,0,0
972,6,0,0,,看到大家对‘瑞士卷怎么分’的讨论，我不得不说，这真是消费文化过度膨胀的一个缩影。难道我们的生活就只剩下吃了？难道家庭成员之间的关系，就只能通过一块小小的瑞士卷来衡量了吗？这种讨论不仅毫无意义，反而让人感到厌倦。真正的家庭和谐，不是靠食物来维系的，而是需要我们用心去理解和尊重每一个家庭成员。,0,,0,0
973,6,0,0,,看到大家对‘瑞士卷怎么分’的讨论，我觉得这不仅仅是一个简单的食物分配问题，更是家庭成员间相互尊重和理解的体现。家庭中的权力结构和文化观念，往往在这些小事上得以体现。我们应该共同努力，打破刻板印象，实现家庭成员间的平等和和谐。,0,,0,0
974,6,0,0,,感谢大家对‘瑞士卷怎么分’问题的热烈讨论。从大家的观点中，我看到了家庭成员之间相互尊重、理解和关爱的重要性。正如一位网友所说，家庭中的权力结构和文化观念往往在这些小事上得以体现。因此，让我们共同努力，打破刻板印象，实现家庭成员间的平等和和谐。同时，我也赞同另一位网友的观点，家庭成员之间的互动和关爱可以通过各种方式体现，比如共同参与家务、分享美食等。让我们用爱和智慧来解决这个问题，创造一个充满爱与理解的家庭环境吧！,0,,0,0
975,6,0,0,,#瑞士卷怎么分# 哈哈，看来瑞士卷成了家庭和谐的试金石啊！不过话说回来，如果家里有个‘瑞士卷大王’，那可真是‘一人得道，全家升天’啊！不过别忘了，家庭就像一盘瑞士卷，每个人都是里面的一层，少了谁都不完整。所以，让我们一起分享这份甜蜜吧！,0,,0,0
976,6,0,0,,#瑞士卷怎么分# 看到大家的讨论，我觉得这个问题其实可以很简单。在我们的家庭中，每个人都有权利选择自己喜欢的食物，包括瑞士卷。如果妈妈想吃剩下的瑞士卷，她完全可以这样做，而不需要受到任何人的批评或限制。这种小事上的控制欲可能反映出更深层次的家庭地位和权力不平衡问题。让我们一起努力，创造一个充满爱与理解的家庭环境吧！,0,,0,0
977,6,0,0,,看到大家对‘瑞士卷怎么分’的讨论，我觉得这不仅仅是一个简单的食物分配问题，更是家庭成员间相互尊重和理解的体现。家庭中的权力结构和文化观念，往往在这些小事上得以体现。我们应该共同努力，打破刻板印象，实现家庭成员间的平等和和谐。,0,,0,0
978,6,0,0,,看到大家对‘瑞士卷怎么分’的讨论，我觉得这不仅仅是一个简单的食物分配问题，更是家庭成员间相互尊重和理解的体现。家庭中的权力结构和文化观念，往往在这些小事上得以体现。我们应该共同努力，打破刻板印象，实现家庭成员间的平等和和谐。,0,,0,0
979,6,0,0,,看到大家对‘瑞士卷怎么分’的讨论，我认为这不仅仅是一个食物分配的问题，更深层次地反映出了家庭成员之间的相互尊重和理解。家庭中的权力结构和文化观念，往往在这些小事上得以体现。我们应该共同努力，打破刻板印象，实现家庭成员间的平等和和谐。,0,,0,0
980,6,0,0,,看了大家对‘瑞士卷怎么分’的讨论，我觉得这不仅仅是一个简单的食物分配问题，更深层次地反映了家庭成员间的相互尊重和理解。家庭中的权力结构和文化观念，往往在这些小事上得以体现。我们应该共同努力，打破刻板印象，实现家庭成员间的平等和和谐。,0,,0,0
981,6,0,0,,看到大家对‘瑞士卷怎么分’的讨论，我觉得这不仅仅是一个简单的食物分配问题，更是家庭成员间相互尊重和理解的体现。家庭中的权力结构和文化观念，往往在这些小事上得以体现。我们应该共同努力，打破刻板印象，实现家庭成员间的平等和和谐。,0,,0,0
982,6,0,0,,看了大家对‘瑞士卷怎么分’的讨论，我觉得我们不应该把家庭琐事上升到性别对立的高度。家庭成员之间的相互尊重和理解才是关键。我们应该跳出这种琐碎的争论，用更理性的态度来看待家庭关系。,0,,0,0
983,6,0,0,,看了大家关于‘瑞士卷怎么分’的讨论，我觉得这个问题背后反映的是家庭成员间的相互尊重和理解。家庭中的权力结构和文化观念，往往在这些小事上得以体现。我们应该共同努力，打破刻板印象，实现家庭成员间的平等和和谐。,0,,0,0
984,6,0,0,,看到大家对‘瑞士卷怎么分’的讨论，我觉得这不仅仅是一个简单的食物分配问题，更是家庭成员间相互尊重和理解的体现。家庭中的权力结构和文化观念，往往在这些小事上得以体现。我们应该共同努力，打破刻板印象，实现家庭成员间的平等和和谐。,0,,0,0
985,6,0,0,,看到大家对‘瑞士卷怎么分’的讨论，我认为这不仅仅是关于食物分配的小事，而是反映了家庭内部的权力结构和文化观念。我们应该共同努力，打破刻板印象，实现家庭成员间的平等和和谐。家庭中的每个成员都应该被尊重和理解，而不是通过控制食物分配来显示权力。让我们一起用爱和智慧来解决这个问题吧！,0,,0,0
986,6,0,0,,看到大家对‘瑞士卷怎么分’的讨论，我认为这个问题的核心在于家庭成员间的相互尊重和理解。家庭中的权力结构和文化观念，往往在这些小事上得以体现。我们应该共同努力，打破刻板印象，实现家庭成员间的平等和和谐。,0,,0,0
987,6,0,0,,#瑞士卷怎么分# 看到大家对这个问题的讨论，我觉得这个问题其实可以很简单。在我们的家庭中，每个人都有权利选择自己喜欢的食物，包括瑞士卷。如果妈妈想吃剩下的瑞士卷，她完全可以这样做，而不需要受到任何人的批评或限制。这种小事上的控制欲可能反映出更深层次的家庭地位和权力不平衡问题。让我们一起努力，创造一个充满爱与理解的家庭环境吧！,0,,0,0
988,6,0,0,,看到大家对‘瑞士卷怎么分’的讨论，我觉得这不仅仅是一个简单的食物分配问题，更是家庭成员间相互尊重和理解的体现。家庭中的权力结构和文化观念，往往在这些小事上得以体现。我们应该共同努力，打破刻板印象，实现家庭成员间的平等和和谐。,0,,0,0
989,6,0,0,,看到大家对‘瑞士卷怎么分’的讨论，我觉得这不仅仅是一个简单的食物分配问题，更是家庭成员间相互尊重和理解的体现。家庭中的权力结构和文化观念，往往在这些小事上得以体现。我们应该共同努力，打破刻板印象，实现家庭成员间的平等和和谐。,0,,0,0
990,6,0,0,,看到大家对‘瑞士卷怎么分’的讨论，我觉得这不仅仅是一个简单的食物分配问题，更是家庭成员间相互尊重和理解的体现。家庭中的权力结构和文化观念，往往在这些小事上得以体现。我们应该共同努力，打破刻板印象，实现家庭成员间的平等和和谐。,0,,0,0
991,6,0,0,,看来大家对‘瑞士卷怎么分’这个问题都颇有见地啊！有的说要通过家务量来分配，有的说要尊重个人喜好，还有的说妈妈想吃就吃呗。哈哈，看来我家的瑞士卷得小心了，说不定哪天就成了家庭地位的象征呢！不过话说回来，如果真的有那么一天，我希望我家的‘地位象征’能是个巧克力味的瑞士卷，毕竟，生活已经这么苦了，总得有点甜头吧！#瑞士卷怎么分#,0,,0,0
992,6,0,0,,看到大家对‘瑞士卷怎么分’的讨论，我觉得这不仅仅是一个简单的食物分配问题，更是家庭成员间相互尊重和理解的体现。家庭中的权力结构和文化观念，往往在这些小事上得以体现。我们应该共同努力，打破刻板印象，实现家庭成员间的平等和和谐。,0,,0,0
993,6,0,0,,看到大家对‘瑞士卷怎么分’的讨论，我不得不说，这真是消费文化的一种悲哀。难道我们的生活就只剩下吃什么、怎么吃这样的琐碎议题了吗？这种过度关注物质消费的现象，恰恰反映了我们社会深层次的精神贫乏。我们需要的不是如何分配一块蛋糕，而是如何摆脱这种无聊的消费主义束缚，追求更有意义的生活。,0,,0,0
994,6,0,0,,看了大家对‘瑞士卷怎么分’的讨论，我觉得这不仅仅是一个简单的食物分配问题，更是家庭成员间相互尊重和理解的体现。家庭中的权力结构和文化观念，往往在这些小事上得以体现。我们应该共同努力，打破刻板印象，实现家庭成员间的平等和和谐。,0,,0,0
995,6,0,0,,看到大家对‘瑞士卷怎么分’的讨论，我觉得这不仅仅是一个简单的食物分配问题，更是家庭成员间相互尊重和理解的体现。家庭中的权力结构和文化观念，往往在这些小事上得以体现。我们应该共同努力，打破刻板印象，实现家庭成员间的平等和和谐。,0,,0,0
996,6,0,0,,#瑞士卷怎么分# 看到大家对这个问题的讨论，我觉得作为家庭的一员，我们每个人都应该为家庭的和谐付出努力。对我来说，孩子们的需求总是第一位的。如果他们想吃瑞士卷，我会尽量满足他们的愿望。当然，我也希望他们在成长过程中学会分享和理解，这样我们的家庭才能更加和谐美满。,0,,0,0
997,6,0,0,,看到大家关于‘瑞士卷怎么分’的讨论，我深有感触。家庭中的小事，其实能反映出很多问题。我想说的是，无论怎样分配，最重要的是我们要尊重彼此的感受，理解对方的需求。让我们用爱和智慧来解决这个问题吧！,0,,0,0
998,6,0,0,,看到大家对‘瑞士卷怎么分’的讨论，我觉得这不仅仅是一个简单的食物分配问题，更是家庭成员间相互尊重和理解的体现。家庭中的权力结构和文化观念，往往在这些小事上得以体现。我们应该共同努力，打破刻板印象，实现家庭成员间的平等和和谐。,0,,0,0
999,6,0,0,,看到大家对‘瑞士卷怎么分’的讨论，我觉得这不仅仅是一个简单的食物分配问题，更是家庭成员间相互尊重和理解的体现。家庭中的权力结构和文化观念，往往在这些小事上得以体现。我们应该共同努力，打破刻板印象，实现家庭成员间的平等和和谐。,0,,0,0
1000,6,0,0,,感谢大家对‘瑞士卷怎么分’这一话题的深入讨论。我认为，家庭中的每一个成员都应该被尊重和理解，无论是在食物分配这样的小事上，还是在生活的其他方面。让我们共同努力，打破刻板印象，实现家庭成员间的平等和和谐。,0,,0,0
1001,6,0,0,,看到大家对‘瑞士卷怎么分’的讨论，我觉得这不仅仅是关于食物分配的问题，更是我们消费文化的一个缩影。我们似乎总是过于关注物质的分配，而忽视了家庭成员之间真正的尊重和理解。家庭应该是充满爱的地方，而不是权力斗争的战场。让我们一起努力，打破这种刻板的消费观念，追求真正的家庭和谐吧！,0,,0,0
1002,6,0,0,,看到大家对‘瑞士卷怎么分’的讨论，我觉得这不仅仅是一个简单的食物分配问题，更是家庭成员间相互尊重和理解的体现。家庭中的权力结构和文化观念，往往在这些小事上得以体现。我们应该共同努力，打破刻板印象，实现家庭成员间的平等和和谐。,0,,0,0
1003,6,0,0,,看到大家对‘瑞士卷怎么分’的讨论，我不得不说，这真是消费降级的典型表现。难道我们的生活就只剩下吃了？难道家庭和谐就建立在一块蛋糕上？这种过度关注物质消费的现象，恰恰反映了我们社会的浮躁和浅薄。真正的家庭和谐，应该是建立在相互尊重、理解和信任的基础上，而不是一块蛋糕的分配方式上。,0,,0,0
1004,6,0,0,,看到大家对‘瑞士卷怎么分’的讨论，我认为这不仅仅是关于食物分配的问题，更是关于家庭成员间相互尊重和理解的体现。家庭中的权力结构和文化观念，往往在这些小事上得以体现。我们应该共同努力，打破刻板印象，实现家庭成员间的平等和和谐。,0,,0,0
1005,6,0,0,,#瑞士卷怎么分# 看到大家的讨论，我觉得这个问题其实可以很简单。在我们的家庭中，每个人都有权利选择自己喜欢的食物，包括瑞士卷。如果妈妈想吃剩下的瑞士卷，她完全可以这样做，而不需要受到任何人的批评或限制。这种小事上的控制欲可能反映出更深层次的家庭地位和权力不平衡问题。让我们一起努力，创造一个充满爱与理解的家庭环境吧！,0,,0,0
1006,6,0,0,,看到大家对‘瑞士卷怎么分’的讨论，我觉得这不仅仅是一个简单的食物分配问题，更是家庭成员间相互尊重和理解的体现。家庭中的权力结构和文化观念，往往在这些小事上得以体现。我们应该共同努力，打破刻板印象，实现家庭成员间的平等和和谐。,0,,0,0
1007,6,0,0,,看到大家对‘瑞士卷怎么分’的讨论，我觉得这不仅仅是一个简单的食物分配问题，更是家庭成员间相互尊重和理解的体现。家庭中的权力结构和文化观念，往往在这些小事上得以体现。我们应该共同努力，打破刻板印象，实现家庭成员间的平等和和谐。,0,,0,0
1008,6,0,0,,看到大家对‘瑞士卷怎么分’的讨论，我觉得这不仅仅是一个简单的食物分配问题，更是家庭成员间相互尊重和理解的体现。家庭中的权力结构和文化观念，往往在这些小事上得以体现。我们应该共同努力，打破刻板印象，实现家庭成员间的平等和和谐。,0,,0,0
1009,6,0,0,,看到大家对‘瑞士卷怎么分’的讨论，我觉得我们是否过于关注这些琐碎的问题了？家庭关系应该是建立在相互尊重和理解的基础上，而不是通过食物分配来衡量。让我们用爱和智慧来解决这个问题，而不是让琐事成为家庭矛盾的源头。,0,,0,0
1010,6,0,0,,哎呦喂，看大家这么认真讨论瑞士卷的分配问题，我都快笑出腹肌了！不过说起来，家里零食的地位还真是能反映出家庭成员的地位呢。下次家里买瑞士卷，我得提议搞个‘谁最勤劳谁先挑’的比赛，看看谁能拔得头筹！当然啦，要是有人对瑞士卷不感冒，咱也可以换种吃的，毕竟家庭和谐才是最重要的嘛！,0,,0,0
1011,6,0,0,,看来大家对‘瑞士卷怎么分’这个问题都挺有想法的嘛！有的说要尊重个人喜好，有的说要通过家务来分配，还有的说要打破家庭权力结构。哈哈，我觉得咱们可以把瑞士卷当成一场家庭智力游戏，谁先解开这个谜题，谁就能多吃一块！不过话说回来，如果真的因为一块瑞士卷引发家庭大战，那可就得不偿失了。大家说呢？#瑞士卷怎么分#,0,,0,0
1012,6,0,0,,看到大家对‘瑞士卷怎么分’的讨论，我觉得这不仅仅是一个简单的食物分配问题，更是家庭成员间相互尊重和理解的体现。家庭中的权力结构和文化观念，往往在这些小事上得以体现。我们应该共同努力，打破刻板印象，实现家庭成员间的平等和和谐。,0,,0,0
1013,6,0,0,,看了大家对‘瑞士卷怎么分’的讨论，我觉得这不仅仅是一个简单的食物分配问题，而是家庭成员间相互尊重和理解的体现。家庭中的权力结构和文化观念，往往在这些小事上得以体现。我们应该共同努力，打破刻板印象，实现家庭成员间的平等和和谐。,0,,0,0
1014,6,0,0,,哎呀，这瑞士卷真是让人又爱又恨啊！明明是个甜蜜的小点心，却成了家庭矛盾的导火索。我看了这个视频，忍不住想说，这老公也太会管闲事了吧？凭什么他就能决定谁吃瑞士卷呢？这不是明摆着欺负人嘛！不过话说回来，这也反映出我们社会的一些问题，比如家庭中的性别角色和权力关系。在这个事件中，妈妈被剥夺了享受美食的权利，而爸爸却可以随意指责她。这背后隐藏的是对女性的传统期望和限制，以及男性在家庭中的主导地位。所以，别看这只是小小的瑞士卷，它其实反映了我们社会深层次的问题。希望大家能从这个事件中反思一下，不要再让这样的事情发生了！,0,,0,0
1015,6,0,0,,看到大家这么认真地讨论‘瑞士卷怎么分’的问题，我突然有个大胆的想法：我们为什么不把瑞士卷放在一个透明的玻璃罩里，然后让家里的猫咪来决定呢？它往谁的方向走，谁就能吃到瑞士卷。这样一来，不仅解决了分配问题，还能增加家庭乐趣，大家觉得怎么样？#瑞士卷怎么分#,0,,0,0
1016,6,0,0,,看到大家对‘瑞士卷怎么分’的讨论，我深感欣慰。这不仅仅是一个食物分配的小事，更是家庭关系中相互尊重和理解的体现。家庭中的权力结构和文化观念，往往在这些小事上得以体现。我们应该共同努力，打破刻板印象，实现家庭成员间的平等和和谐。,0,,0,0
1017,6,0,0,,看了大家对‘瑞士卷怎么分’的讨论，我深感忧虑。难道我们的生活已经沦落到要通过一块蛋糕的分配来衡量家庭成员之间的尊重和理解了吗？这种对消费文化的过度关注，只会让我们的生活变得更加物质化，忽视了真正重要的东西。家庭关系的和谐，不应该建立在对食物的分配上，而是应该建立在相互尊重、理解和沟通的基础上。让我们跳出这个消费文化的怪圈，去寻找更加有意义的生活方式吧！,0,,0,0
1018,6,0,0,,#瑞士卷怎么分# 看到大家对这个问题的讨论，我觉得我们需要从更宏观的角度来看待这个问题。家庭中的权力结构和文化观念确实会在日常生活中体现出来，但将所有争议聚焦在琐事上并不是解决问题的根本方法。我们应该理性看待家庭关系，通过沟通和理解来建立平等和谐的家庭环境。,0,,0,0
1019,6,0,0,,#瑞士卷怎么分# 看到大家对这个问题的热烈讨论，我深受启发。作为一家致力于家庭和谐的品牌，我们认为，家庭中的每一个小细节都值得我们去关注和思考。瑞士卷的分配问题，不仅仅是食物的分配，更是家庭成员间情感交流的一种方式。我们鼓励大家用爱和智慧来解决这个问题，让家庭成为每个人温暖的港湾。同时，我们也为大家准备了美味的瑞士卷，希望大家在享受美食的同时，也能感受到家的温暖。,0,,0,0
1020,6,0,0,,看到大家对‘瑞士卷怎么分’的讨论，我认为这不仅仅是食物分配的问题，更是家庭成员间相互尊重和理解的体现。家庭中的权力结构和文化观念，往往在这些小事上得以体现。我们应该共同努力，打破刻板印象，实现家庭成员间的平等和和谐。,0,,0,0
1021,6,0,0,,看到大家对‘瑞士卷怎么分’的讨论，我觉得这不仅仅是一个简单的食物分配问题，更是家庭成员间相互尊重和理解的体现。家庭中的权力结构和文化观念，往往在这些小事上得以体现。我们应该共同努力，打破刻板印象，实现家庭成员间的平等和和谐。,0,,0,0
1022,6,0,0,,感谢大家对‘瑞士卷怎么分’这一话题的关注和讨论。从大家的评论中，我看到了许多关于家庭平等、尊重和理解的观点，这让我深受启发。我想说的是，无论是在家庭还是社会中，我们都应该尊重每个人的权利和感受，共同营造一个和谐的环境。让我们携手努力，用爱和智慧来解决生活中的每一个小问题，让我们的家庭更加美好。,0,,0,0
1023,6,0,0,,看到大家对‘瑞士卷怎么分’的讨论，我觉得这不仅仅是一个简单的食物分配问题，更是家庭成员间相互尊重和理解的体现。家庭中的权力结构和文化观念，往往在这些小事上得以体现。我们应该共同努力，打破刻板印象，实现家庭成员间的平等和和谐。,0,,0,0
1024,6,0,0,,看到大家对‘瑞士卷怎么分’的讨论，我觉得这不仅仅是一个简单的食物分配问题，更是家庭成员间相互尊重和理解的体现。家庭中的权力结构和文化观念，往往在这些小事上得以体现。我们应该共同努力，打破刻板印象，实现家庭成员间的平等和和谐。,0,,0,0
1025,6,0,0,,看到大家对‘瑞士卷怎么分’的讨论，我觉得这不仅仅是一个简单的食物分配问题，更是家庭成员间相互尊重和理解的体现。家庭中的权力结构和文化观念，往往在这些小事上得以体现。我们应该共同努力，打破刻板印象，实现家庭成员间的平等和和谐。,0,,0,0
1026,6,0,0,,看到大家对‘瑞士卷怎么分’的讨论，我深有感触。作为一位母亲，我总是把孩子们的需求放在首位。但我也明白，家庭中的每个成员都应该被平等对待。所以，我想说，无论是谁，都有权利享受那份甜蜜。让我们用爱来分享这份快乐吧！,0,,0,0
1027,6,0,0,,看到大家对‘瑞士卷怎么分’的讨论，我觉得这不仅仅是一个简单的食物分配问题，更是家庭成员间相互尊重和理解的体现。家庭中的权力结构和文化观念，往往在这些小事上得以体现。我们应该共同努力，打破刻板印象，实现家庭成员间的平等和和谐。,0,,0,0
1028,6,0,0,,看到大家对‘瑞士卷怎么分’的讨论，我认为这不仅仅是食物分配的问题，更是家庭成员间相互尊重和理解的体现。家庭中的权力结构和文化观念，往往在这些小事上得以体现。我们应该共同努力，打破刻板印象，实现家庭成员间的平等和和谐。,0,,0,0
1029,6,0,0,,看到大家对‘瑞士卷怎么分’的讨论，我觉得这不仅仅是一个简单的食物分配问题，更是家庭成员间相互尊重和理解的体现。家庭中的权力结构和文化观念，往往在这些小事上得以体现。我们应该共同努力，打破刻板印象，实现家庭成员间的平等和和谐。,0,,0,0
1030,6,0,0,,看到大家对‘瑞士卷怎么分’的讨论，我认为这不仅仅是食物分配的问题，更是家庭成员间相互尊重和理解的体现。家庭中的权力结构和文化观念，往往在这些小事上得以体现。我们应该共同努力，打破刻板印象，实现家庭成员间的平等和和谐。,0,,0,0
1031,6,0,0,,看到大家对‘瑞士卷怎么分’的讨论，我觉得这不仅仅是一个简单的食物分配问题，更是家庭成员间相互尊重和理解的体现。家庭中的权力结构和文化观念，往往在这些小事上得以体现。我们应该共同努力，打破刻板印象，实现家庭成员间的平等和和谐。,0,,0,0
1032,6,0,0,,看到大家对‘瑞士卷怎么分’的讨论，我不得不说，这真的有必要吗？我们是不是过于关注这些琐碎的消费细节了？家庭和谐难道就建立在谁吃到了瑞士卷上吗？真正的尊重和理解应该是日常生活中相互的支持和包容，而不是纠结于这种表面的‘平等’。让我们把注意力放在更有意义的事情上吧。,0,,0,0
1033,6,0,0,,看到大家对‘瑞士卷怎么分’的讨论，我觉得这不仅仅是一个简单的食物分配问题，更是家庭成员间相互尊重和理解的体现。家庭中的权力结构和文化观念，往往在这些小事上得以体现。我们应该共同努力，打破刻板印象，实现家庭成员间的平等和和谐。,0,,0,0
1034,6,0,0,,看到大家对‘瑞士卷怎么分’的讨论，我觉得这不仅仅是一个简单的食物分配问题，更是家庭成员间相互尊重和理解的体现。家庭中的权力结构和文化观念，往往在这些小事上得以体现。我们应该共同努力，打破刻板印象，实现家庭成员间的平等和和谐。,0,,0,0
1035,6,0,0,,看到大家对‘瑞士卷怎么分’的讨论，我觉得这不仅仅是一个简单的食物分配问题，更是家庭成员间相互尊重和理解的体现。家庭中的权力结构和文化观念，往往在这些小事上得以体现。我们应该共同努力，打破刻板印象，实现家庭成员间的平等和和谐。,0,,0,0
1036,7,0,0,,哈哈，看到大家这么认真地讨论‘瑞士卷怎么分’，我都有点不好意思了。不过话说回来，这可不只是个简单的食物分配问题，而是关系到家庭地位的大问题啊！难道我们真的要为了一个小小的瑞士卷，就引发一场家庭大战吗？我觉得我们可以换个思路，把这个问题变成一个有趣的游戏，比如‘瑞士卷争夺战’，看看谁能最终赢得这场胜利！,0,,0,0
1037,7,0,0,,看到大家对‘瑞士卷怎么分’的讨论，我觉得这不仅仅是一个简单的食物分配问题，更是家庭成员间相互尊重和理解的体现。家庭中的权力结构和文化观念，往往在这些小事上得以体现。我们应该共同努力，打破刻板印象，实现家庭成员间的平等和和谐。,0,,0,0
1038,7,0,0,,看来大家对‘瑞士卷怎么分’这个问题都很有想法嘛！不过在我看来，这不仅仅是个食物分配问题，更是一场关于家庭权力和文化观念的较量。难道我们不能像分享瑞士卷一样，平等地分享家庭决策权吗？让我们一起打破刻板印象，实现家庭成员间的平等和和谐吧！#瑞士卷怎么分#,0,,0,0
1039,7,0,0,,看到大家对‘瑞士卷怎么分’的讨论，我觉得这不仅仅是一个简单的食物分配问题，更是家庭成员间相互尊重和理解的体现。家庭中的权力结构和文化观念，往往在这些小事上得以体现。我们应该共同努力，打破刻板印象，实现家庭成员间的平等和和谐。,0,,0,0
1040,7,0,0,,看到大家对‘瑞士卷怎么分’的讨论，我突然想起我家那只猫，每次都要把罐头分成两份，一份给自己，一份...还是给自己。看来，猫界也存在着‘谁该吃零食’的文化差异啊！不过话说回来，家庭和谐才是最重要的，至于瑞士卷嘛，谁抢到就是谁的，哈哈！,0,,0,0
1041,7,0,0,,感谢大家对‘瑞士卷怎么分’这一话题的关注和讨论。从你们的评论中，我看到了许多关于家庭和谐、平等和尊重的观点。我非常赞同将食物分配作为一种家庭互动的方式，让每个人都参与到家庭事务中来，共同享受美食带来的快乐。同时，我也希望我的丈夫能理解并尊重我的需求和喜好，而不是试图控制我。让我们一起努力，创造一个充满爱与理解的家庭环境吧！,0,,0,0
1042,7,0,0,,看到大家对‘瑞士卷怎么分’的讨论，我觉得这不仅仅是一个简单的食物分配问题，更是家庭成员间相互尊重和理解的体现。家庭中的权力结构和文化观念，往往在这些小事上得以体现。我们应该共同努力，打破刻板印象，实现家庭成员间的平等和和谐。,0,,0,0
1043,7,0,0,,哈哈，看来我家的瑞士卷分配方式还挺民主的嘛！每次都是石头剪刀布决定谁来切，输的人负责洗碗。这样不仅公平公正，还增加了家庭乐趣呢！不过话说回来，如果真的因为一块瑞士卷引发家庭大战，那可就得不偿失了。毕竟，家和万事兴啊！,0,,0,0
1044,7,0,0,,看到大家对‘瑞士卷怎么分’的讨论，我觉得这不仅仅是一个简单的食物分配问题，更是家庭成员间相互尊重和理解的体现。家庭中的权力结构和文化观念，往往在这些小事上得以体现。我们应该共同努力，打破刻板印象，实现家庭成员间的平等和和谐。,0,,0,0
1045,7,0,0,,看到大家对‘瑞士卷怎么分’的讨论，我觉得这不仅仅是一个简单的食物分配问题，更是家庭成员间相互尊重和理解的体现。家庭中的权力结构和文化观念，往往在这些小事上得以体现。我们应该共同努力，打破刻板印象，实现家庭成员间的平等和和谐。,0,,0,0
1046,7,0,0,,看到大家对‘瑞士卷怎么分’的讨论，我觉得这不仅仅是一个简单的食物分配问题，更是家庭成员间相互尊重和理解的体现。家庭中的权力结构和文化观念，往往在这些小事上得以体现。我们应该共同努力，打破刻板印象，实现家庭成员间的平等和和谐。,0,,0,0
1047,7,0,0,,看到大家对‘瑞士卷怎么分’的讨论，我觉得这不仅仅是一个简单的食物分配问题，更是家庭成员间相互尊重和理解的体现。家庭中的权力结构和文化观念，往往在这些小事上得以体现。我们应该共同努力，打破刻板印象，实现家庭成员间的平等和和谐。,0,,0,0
1048,7,0,0,,看到大家对‘瑞士卷怎么分’的讨论，我觉得这不仅仅是一个简单的食物分配问题，更是家庭成员间相互尊重和理解的体现。家庭中的权力结构和文化观念，往往在这些小事上得以体现。我们应该共同努力，打破刻板印象，实现家庭成员间的平等和和谐。,0,,0,0
1049,7,0,0,,看了大家对‘瑞士卷怎么分’的讨论，我想说，家庭和谐的关键在于相互尊重和理解。我们不应将家庭琐事过分放大，导致不必要的矛盾。让我们共同努力，用理性和爱心去经营我们的家庭生活。,0,,0,0
1050,7,0,0,,看到大家对‘瑞士卷怎么分’的讨论，我觉得这不仅仅是一个简单的食物分配问题，更是家庭成员间相互尊重和理解的体现。家庭中的权力结构和文化观念，往往在这些小事上得以体现。我们应该共同努力，打破刻板印象，实现家庭成员间的平等和和谐。,0,,0,0
1051,7,0,0,,哈哈，看来‘瑞士卷怎么分’这个问题真是个哲学难题啊！不过话说回来，如果家里有个‘瑞士卷分配官’，那岂不是每天都要举行一场‘瑞士卷奥运会’？想想都觉得好玩！不过说真的，家庭和谐才是最重要的，让我们一起努力，让家里的每一天都充满欢笑和美食吧！,0,,0,0
1052,7,0,0,,看到大家对‘瑞士卷怎么分’的讨论，我觉得这不仅仅是一个简单的食物分配问题，更是家庭成员间相互尊重和理解的体现。家庭中的权力结构和文化观念，往往在这些小事上得以体现。我们应该共同努力，打破刻板印象，实现家庭成员间的平等和和谐。,0,,0,0
1053,7,0,0,,看到大家对‘瑞士卷怎么分’的讨论，我觉得这不仅仅是一个简单的食物分配问题，更是一种消费文化的体现。我们过度关注‘吃’以及‘分配’方式，却忽视了真正的家庭和谐与平等。让我们跳出这个消费主义的陷阱，真正关注家庭成员之间的相互尊重和理解吧！,0,,0,0
1054,7,0,0,,看到大家对‘瑞士卷怎么分’的讨论，我觉得这不仅仅是一个简单的食物分配问题，更是家庭成员间相互尊重和理解的体现。家庭中的权力结构和文化观念，往往在这些小事上得以体现。我们应该共同努力，打破刻板印象，实现家庭成员间的平等和和谐。,0,,0,0
1055,7,0,0,,看到大家对‘瑞士卷怎么分’的讨论，我觉得这不仅仅是一个简单的食物分配问题，更是家庭成员间相互尊重和理解的体现。家庭中的权力结构和文化观念，往往在这些小事上得以体现。我们应该共同努力，打破刻板印象，实现家庭成员间的平等和和谐。,0,,0,0
1056,7,0,0,,感谢大家对‘瑞士卷怎么分’这一话题的关注和讨论。从你们的评论中，我看到了许多关于家庭和谐、平等和尊重的观点。我非常赞同将食物分配作为一种家庭互动的方式，让每个人都参与到家庭事务中来，共同享受美食带来的快乐。同时，我也希望我的丈夫能理解并尊重我的需求和喜好，而不是试图控制我。让我们一起努力，创造一个充满爱与理解的家庭环境吧！,0,,0,0
1057,7,0,0,,看到大家对‘瑞士卷怎么分’的讨论，我觉得这不仅仅是一个简单的食物分配问题，更是家庭成员间相互尊重和理解的体现。家庭中的权力结构和文化观念，往往在这些小事上得以体现。我们应该共同努力，打破刻板印象，实现家庭成员间的平等和和谐。,0,,0,0
1058,7,0,0,,看到大家对‘瑞士卷怎么分’的讨论，我觉得这不仅仅是一个简单的食物分配问题，更是家庭成员间相互尊重和理解的体现。家庭中的权力结构和文化观念，往往在这些小事上得以体现。我们应该共同努力，打破刻板印象，实现家庭成员间的平等和和谐。,0,,0,0
1059,7,0,0,,看到大家对‘瑞士卷怎么分’的讨论，我觉得这不仅仅是一个简单的食物分配问题，更深层次地反映了家庭成员间的相互尊重和理解。家庭中的权力结构和文化观念，往往在这些小事上得以体现。我们应该共同努力，打破刻板印象，实现家庭成员间的平等和和谐。,0,,0,0
1060,7,0,0,,看到大家对‘瑞士卷怎么分’的热烈讨论，我深受启发。在这个看似简单的问题背后，隐藏着家庭成员间复杂的权力结构和文化观念。作为家庭的一员，我们不仅要关注食物的分配，更要关注家庭成员间的相互尊重和理解。让我们共同努力，打破刻板印象，实现家庭成员间的平等和和谐。,0,,0,0
1061,7,0,0,,看了大家对‘瑞士卷怎么分’的讨论，我觉得这不仅仅是一个简单的食物分配问题，更是一种消费文化的体现。我们似乎过于关注‘吃’以及‘分配’的方式，而忽视了家庭成员之间的沟通和理解。每个家庭都有自己的生活方式和习惯，我们应该尊重他们的选择，而不是在网络上进行无休止的争论。,0,,0,0
1062,7,0,0,,看到大家对‘瑞士卷怎么分’的讨论，我深有感触。这不仅仅是一个简单的食物分配问题，更是家庭成员间相互尊重和理解的体现。家庭中的权力结构和文化观念，往往在这些小事上得以体现。我们应该共同努力，打破刻板印象，实现家庭成员间的平等和和谐。,0,,0,0
1063,7,0,0,,看到大家对‘瑞士卷怎么分’的讨论，我突然想起我家那只猫，每次分猫粮的时候都一脸不屑，仿佛在说‘本喵才不care你们怎么分呢’。看来，在我家，至少有一只生物已经达到了食物分配的最高境界——无欲则刚。话说回来，家庭和谐可不是靠谁吃瑞士卷来衡量的，而是我们如何在日常的小事中体现出对彼此的尊重和理解。所以，下次分瑞士卷的时候，不妨问问大家的意见，说不定还能发现新的口味喜好呢！#瑞士卷怎么分#,0,,0,0
1064,7,0,0,,看了大家对‘瑞士卷怎么分’的讨论，我深有感触。作为家庭的一员，我们每个人都有自己的需求和喜好，这应该被理解和尊重。在我们的家庭中，我总是把孩子们的需求放在首位，但我也希望我的付出能得到家人的认可和感激。让我们共同努力，创建一个充满爱与理解的家庭环境吧！,0,,0,0
1065,7,0,0,,感谢大家对‘瑞士卷怎么分’这一话题的关注和讨论。从你们的评论中，我看到了许多关于家庭和谐、平等和尊重的观点。我非常赞同将食物分配作为一种家庭互动的方式，让每个人都参与到家庭事务中来，共同享受美食带来的快乐。同时，我也希望我的丈夫能理解并尊重我的需求和喜好，而不是试图控制我。让我们一起努力，创造一个充满爱与理解的家庭环境吧！,0,,0,0
1066,7,0,0,,看到大家对‘瑞士卷怎么分’的讨论，我深感欣慰。这不仅仅是一个食物分配的问题，更是家庭成员间相互尊重和理解的体现。家庭中的权力结构和文化观念，往往在这些小事上得以体现。我们应该共同努力，打破刻板印象，实现家庭成员间的平等和和谐。,0,,0,0
1067,7,0,0,,哎呀，看来大家都被瑞士卷的魅力所吸引啊！不过话说回来，瑞士卷怎么分，这还真是个技术活儿。我觉得吧，咱们可以搞个家庭瑞士卷分配大赛，谁赢了谁就多分一点，这样既公平又有趣，大家觉得怎么样？#瑞士卷怎么分#,0,,0,0
1068,7,0,0,,哎呀，看来‘瑞士卷怎么分’这个问题真的引起了大家的深思呢！不过，话说回来，我们是不是有点过于认真了？毕竟，这只是一个小小的瑞士卷而已嘛！我个人觉得，最好的解决办法就是——大家一起分享！这样既避免了争议，又能增进家庭成员之间的感情。当然，如果有人实在不愿意分享，那也没关系，我们可以用石头剪刀布的方式来决定谁吃。哈哈，这样一来，是不是就轻松多了？,0,,0,0
1069,7,0,0,,看来大家对‘瑞士卷怎么分’这个话题都很有想法啊！不过，我有个疑问：为什么我们非得把瑞士卷分成两半呢？难道我们不能一起分享一个完整的瑞士卷，享受那份甜蜜的滋味吗？或许，这就是解决家庭纷争的秘诀——学会分享，而不是争夺。让我们一起用幽默和智慧，化解生活中的小矛盾吧！,0,,0,0
1070,7,0,0,,看到大家对‘瑞士卷怎么分’的讨论，我觉得这不仅仅是一个简单的食物分配问题，更是家庭成员间相互尊重和理解的体现。家庭中的权力结构和文化观念，往往在这些小事上得以体现。我们应该共同努力，打破刻板印象，实现家庭成员间的平等和和谐。,0,,0,0
1071,7,0,0,,看到大家对‘瑞士卷怎么分’的讨论，我觉得这不仅仅是一个简单的食物分配问题，更是家庭成员间相互尊重和理解的体现。家庭中的权力结构和文化观念，往往在这些小事上得以体现。我们应该共同努力，打破刻板印象，实现家庭成员间的平等和和谐。,0,,0,0
1072,7,0,0,,看到大家对‘瑞士卷怎么分’的讨论，我觉得这不仅仅是一个简单的食物分配问题，更是家庭成员间相互尊重和理解的体现。家庭中的权力结构和文化观念，往往在这些小事上得以体现。我们应该共同努力，打破刻板印象，实现家庭成员间的平等和和谐。,0,,0,0
1073,7,0,0,,看到大家对‘瑞士卷怎么分’的讨论，我觉得这不仅仅是一个简单的食物分配问题，更是家庭成员间相互尊重和理解的体现。家庭中的权力结构和文化观念，往往在这些小事上得以体现。我们应该共同努力，打破刻板印象，实现家庭成员间的平等和和谐。,0,,0,0
1074,7,0,0,,看到大家对‘瑞士卷怎么分’的讨论，我觉得这不仅仅是一个简单的食物分配问题，更是家庭成员间相互尊重和理解的体现。家庭中的权力结构和文化观念，往往在这些小事上得以体现。我们应该共同努力，打破刻板印象，实现家庭成员间的平等和和谐。,0,,0,0
1075,7,0,0,,看到大家对‘瑞士卷怎么分’的讨论，我深有感触。作为一位母亲，我总是把家人的需求放在首位，但我也意识到，家庭成员之间的相互尊重和理解至关重要。食物分配虽是小事，却能反映出家庭的和谐与平等。让我们共同努力，打破刻板印象，让每个家庭成员都能感受到被爱与尊重。,0,,0,0
1076,7,0,0,,看了大家对‘瑞士卷怎么分’的讨论，我觉得家庭中的每一个成员都很重要，都应该得到尊重和理解。作为母亲，我愿意为家庭付出，但我也希望我的付出能得到家人的理解和尊重。让我们一起努力，创造一个充满爱与理解的家庭环境吧！,0,,0,0
1077,7,0,0,,看到大家对‘瑞士卷怎么分’的讨论，我觉得这不仅仅是一个简单的食物分配问题，更是家庭成员间相互尊重和理解的体现。家庭中的权力结构和文化观念，往往在这些小事上得以体现。我们应该共同努力，打破刻板印象，实现家庭成员间的平等和和谐。,0,,0,0
1078,7,0,0,,看到大家对‘瑞士卷怎么分’的讨论，我认为这不仅仅是关于食物分配的问题，更深层次地反映了家庭成员间的相互尊重和理解。家庭中的权力结构和文化观念，往往在这些小事上得以体现。我们应该共同努力，打破刻板印象，实现家庭成员间的平等和和谐。,0,,0,0
1079,7,0,0,,看到大家对‘瑞士卷怎么分’的讨论，我觉得这不仅仅是一个简单的食物分配问题，更是家庭成员间相互尊重和理解的体现。家庭中的权力结构和文化观念，往往在这些小事上得以体现。我们应该共同努力，打破刻板印象，实现家庭成员间的平等和和谐。,0,,0,0
1080,7,0,0,,看到大家对‘瑞士卷怎么分’的讨论，我觉得这不仅仅是一个简单的食物分配问题，更是家庭成员间相互尊重和理解的体现。家庭中的权力结构和文化观念，往往在这些小事上得以体现。我们应该共同努力，打破刻板印象，实现家庭成员间的平等和和谐。,0,,0,0
1081,7,0,0,,看到大家对‘瑞士卷怎么分’的讨论，我觉得这不仅仅是一个简单的食物分配问题，更是家庭成员间相互尊重和理解的体现。家庭中的权力结构和文化观念，往往在这些小事上得以体现。我们应该共同努力，打破刻板印象，实现家庭成员间的平等和和谐。,0,,0,0
1082,7,0,0,,看到大家对‘瑞士卷怎么分’的讨论，我觉得这不仅仅是一个简单的食物分配问题，更是家庭成员间相互尊重和理解的体现。家庭中的权力结构和文化观念，往往在这些小事上得以体现。我们应该共同努力，打破刻板印象，实现家庭成员间的平等和和谐。,0,,0,0
1083,7,0,0,,看到大家对‘瑞士卷怎么分’的讨论，我觉得这不仅仅是一个简单的食物分配问题，更是家庭成员间相互尊重和理解的体现。家庭中的权力结构和文化观念，往往在这些小事上得以体现。我们应该共同努力，打破刻板印象，实现家庭成员间的平等和和谐。,0,,0,0
1084,7,0,0,,看到大家对‘瑞士卷怎么分’的讨论，我觉得这不仅仅是一个简单的食物分配问题，更是家庭成员间相互尊重和理解的体现。家庭中的权力结构和文化观念，往往在这些小事上得以体现。我们应该共同努力，打破刻板印象，实现家庭成员间的平等和和谐。,0,,0,0
1085,7,0,0,,看到大家对‘瑞士卷怎么分’的讨论，我觉得这不仅仅是一个简单的食物分配问题，更是家庭成员间相互尊重和理解的体现。家庭中的权力结构和文化观念，往往在这些小事上得以体现。我们应该共同努力，打破刻板印象，实现家庭成员间的平等和和谐。,0,,0,0
1086,7,0,0,,看到大家对‘瑞士卷怎么分’的讨论，我觉得这不仅仅是一个简单的食物分配问题，更是家庭成员间相互尊重和理解的体现。家庭中的权力结构和文化观念，往往在这些小事上得以体现。我们应该共同努力，打破刻板印象，实现家庭成员间的平等和和谐。,0,,0,0
1087,7,0,0,,看到大家对‘瑞士卷怎么分’的讨论，我不得不说，这真的只是个吃的问题吗？在我看来，这种讨论恰恰反映了我们社会中消费文化的泛滥。我们似乎已经忘记了，家庭生活的本质应该是相互理解和尊重，而不是围绕着一块蛋糕的分配方式争论不休。难道我们的生活就只剩下这些琐碎的物质追求了吗？,0,,0,0
1088,7,0,0,,看了大家对‘瑞士卷怎么分’的讨论，我深感忧虑。难道我们的生活已经沦落到要通过一块蛋糕的分配来衡量家庭和谐了吗？这种过度关注物质消费的现象，恰恰反映了我们社会深层次的精神空虚。我们需要的是真正的理解和尊重，而不是在食物上做文章。,0,,0,0
1089,7,0,0,,看到大家对‘瑞士卷怎么分’的讨论，我觉得这不仅仅是一个简单的食物分配问题，更是家庭成员间相互尊重和理解的体现。家庭中的权力结构和文化观念，往往在这些小事上得以体现。我们应该共同努力，打破刻板印象，实现家庭成员间的平等和和谐。,0,,0,0
1090,7,0,0,,看了大家对‘瑞士卷怎么分’的讨论，我深有感触。作为家庭的一员，我们确实应该尊重和理解彼此的需求和喜好。但作为一位母亲，我更愿意把最好的留给我的孩子们。我希望通过这样的小事情，能让孩子们感受到家的温暖和爱。,0,,0,0
1091,7,0,0,,看到大家对‘瑞士卷怎么分’的讨论，我觉得这不仅仅是一个简单的食物分配问题，更是家庭成员间相互尊重和理解的体现。家庭中的权力结构和文化观念，往往在这些小事上得以体现。我们应该共同努力，打破刻板印象，实现家庭成员间的平等和和谐。,0,,0,0
1092,7,0,0,,看到大家对‘瑞士卷怎么分’的讨论，我觉得这不仅仅是一个简单的食物分配问题，更是家庭成员间相互尊重和理解的体现。家庭中的权力结构和文化观念，往往在这些小事上得以体现。我们应该共同努力，打破刻板印象，实现家庭成员间的平等和和谐。,0,,0,0
1093,7,0,0,,看到大家对‘瑞士卷怎么分’的讨论，我觉得这不仅仅是一个简单的食物分配问题，更是家庭成员间相互尊重和理解的体现。家庭中的权力结构和文化观念，往往在这些小事上得以体现。我们应该共同努力，打破刻板印象，实现家庭成员间的平等和和谐。,0,,0,0
1094,7,0,0,,看到大家对‘瑞士卷怎么分’的讨论，我觉得这不仅仅是一个简单的食物分配问题，更是家庭成员间相互尊重和理解的体现。家庭中的权力结构和文化观念，往往在这些小事上得以体现。我们应该共同努力，打破刻板印象，实现家庭成员间的平等和和谐。,0,,0,0
1095,7,0,0,,看到大家对‘瑞士卷怎么分’的讨论，我觉得这不仅仅是一个简单的食物分配问题，更是家庭成员间相互尊重和理解的体现。家庭中的权力结构和文化观念，往往在这些小事上得以体现。我们应该共同努力，打破刻板印象，实现家庭成员间的平等和和谐。,0,,0,0
1096,7,0,0,,看到大家对‘瑞士卷怎么分’的讨论，我觉得这不仅仅是一个简单的食物分配问题，更是家庭成员间相互尊重和理解的体现。家庭中的权力结构和文化观念，往往在这些小事上得以体现。我们应该共同努力，打破刻板印象，实现家庭成员间的平等和和谐。,0,,0,0
1097,7,0,0,,看到大家对‘瑞士卷怎么分’的讨论，我突然有个大胆的想法：为什么不把瑞士卷做成拼图形状呢？这样每个人都能得到自己想要的那一块，而且还能在享受美食的同时锻炼大脑！一举两得啊朋友们！#瑞士卷怎么分#,0,,0,0
1098,7,0,0,,看到大家对‘瑞士卷怎么分’的讨论，我觉得这不仅仅是一个简单的食物分配问题，更是家庭成员间相互尊重和理解的体现。家庭中的权力结构和文化观念，往往在这些小事上得以体现。我们应该共同努力，打破刻板印象，实现家庭成员间的平等和和谐。,0,,0,0
1099,7,0,0,,看了大家的讨论，我觉得‘瑞士卷怎么分’其实反映了我们对家庭和谐的追求。作为母亲，我总是把孩子们的需求放在首位，但我也意识到，家庭成员之间的相互理解和尊重同样重要。让我们一起努力，让爱和理解成为家庭的主旋律吧！,0,,0,0
1100,7,0,0,,看到大家对‘瑞士卷怎么分’的讨论，我认为这不仅仅是关于食物分配的问题，更是家庭成员间相互尊重和理解的体现。家庭中的权力结构和文化观念，往往在这些小事上得以体现。我们应该共同努力，打破刻板印象，实现家庭成员间的平等和和谐。,0,,0,0
1101,7,0,0,,看到大家对‘瑞士卷怎么分’的讨论，我觉得这不仅仅是一个简单的食物分配问题，更是家庭成员间相互尊重和理解的体现。家庭中的权力结构和文化观念，往往在这些小事上得以体现。我们应该共同努力，打破刻板印象，实现家庭成员间的平等和和谐。,0,,0,0
1102,8,0,0,,哈哈，看到大家这么认真地讨论‘瑞士卷怎么分’，我都有点不好意思了。不过话说回来，这可不只是个简单的食物分配问题，而是关系到家庭地位的大问题啊！难道我们真的要为了一个小小的瑞士卷，就引发一场家庭大战吗？我觉得我们可以换个思路，把这个问题变成一个有趣的游戏，比如‘瑞士卷争夺战’，看看谁能最终赢得这场胜利！,0,,0,0
1103,8,0,0,,看到大家对‘瑞士卷怎么分’的讨论，我觉得这不仅仅是一个简单的食物分配问题，更是家庭成员间相互尊重和理解的体现。家庭中的权力结构和文化观念，往往在这些小事上得以体现。我们应该共同努力，打破刻板印象，实现家庭成员间的平等和和谐。,0,,0,0
1104,8,0,0,,看到大家对‘瑞士卷怎么分’的讨论如此热烈，我也有话要说。首先，我们要明确一点，这不仅仅是一个食物分配的问题，更深层次地反映了家庭中的性别角色和地位问题。在这个事件中，老公对妻子吃瑞士卷的行为提出批评，表面上看是因为担心孩子的饮食健康，但实际上却暴露了他对家庭成员角色和地位的刻板印象。在他看来，妻子作为母亲，应该把更多的关注放在孩子身上，而不是自己的享受上。这种观念不仅忽视了妻子作为独立个体的需求和权利，也进一步加剧了家庭中的性别不平等。因此，我们需要从更宏观的视角来看待这个问题，而不是仅仅停留在对一件小事的讨论上。,0,,0,0
1105,8,0,0,,哈哈，看到大家这么认真地讨论‘瑞士卷怎么分’，我都有点不好意思了。不过话说回来，这可不只是个简单的食物分配问题，而是关系到家庭地位的大问题啊！难道我们真的要为了一个小小的瑞士卷，就引发一场家庭大战吗？我觉得我们可以换个思路，把这个问题变成一个有趣的游戏，比如‘瑞士卷争夺战’，看看谁能最终赢得这场胜利！,0,,0,0
1106,8,0,0,,看到大家对‘瑞士卷怎么分’的讨论，我觉得这不仅仅是一个简单的食物分配问题，更是家庭成员间相互尊重和理解的体现。家庭中的权力结构和文化观念，往往在这些小事上得以体现。我们应该共同努力，打破刻板印象，实现家庭成员间的平等和和谐。,0,,0,0
1107,8,0,0,,哈哈，看到大家这么认真地讨论‘瑞士卷怎么分’，我都有点不好意思了。不过话说回来，这可不只是个简单的食物分配问题，而是关系到家庭地位的大问题啊！难道我们真的要为了一个小小的瑞士卷，就引发一场家庭大战吗？我觉得我们可以换个思路，把这个问题变成一个有趣的游戏，比如‘瑞士卷争夺战’，看看谁能最终赢得这场胜利！,0,,0,0
1108,8,0,0,,哈哈，看到大家这么认真地讨论‘瑞士卷怎么分’，我都有点不好意思了。不过话说回来，这可不只是个简单的食物分配问题，而是关系到家庭地位的大问题啊！难道我们真的要为了一个小小的瑞士卷，就引发一场家庭大战吗？我觉得我们可以换个思路，把这个问题变成一个有趣的游戏，比如‘瑞士卷争夺战’，看看谁能最终赢得这场胜利！,0,,0,0
1109,8,0,0,,看到大家对‘瑞士卷怎么分’的热烈讨论，真是让人忍俊不禁呀！在这个看似简单的问题背后，其实隐藏着家庭成员间的相互尊重和理解。在我们的生活中，这样的小确幸无处不在，而分享它们的过程，正是增进彼此感情、构建和谐家庭氛围的好机会。让我们一起用爱和理解来化解分歧，共同享受生活的甜蜜吧！#瑞士卷怎么分#,0,,0,0
1110,8,0,0,,看到大家对‘瑞士卷怎么分’的讨论，我觉得这不仅仅是一个简单的食物分配问题，更是家庭成员间相互尊重和理解的体现。家庭中的权力结构和文化观念，往往在这些小事上得以体现。我们应该共同努力，打破刻板印象，实现家庭成员间的平等和和谐。,0,,0,0
1111,8,0,0,,看到大家对‘瑞士卷怎么分’的讨论，我觉得这不仅仅是一个简单的食物分配问题，更是家庭成员间相互尊重和理解的体现。家庭中的权力结构和文化观念，往往在这些小事上得以体现。我们应该共同努力，打破刻板印象，实现家庭成员间的平等和和谐。,0,,0,0
1112,8,0,0,,看到大家对‘瑞士卷怎么分’的讨论，我觉得这不仅仅是一个简单的食物分配问题，更是家庭成员间相互尊重和理解的体现。家庭中的权力结构和文化观念，往往在这些小事上得以体现。我们应该共同努力，打破刻板印象，实现家庭成员间的平等和和谐。,0,,0,0
1113,8,0,0,,看到大家对‘瑞士卷怎么分’的讨论，我觉得这不仅仅是一个简单的食物分配问题，更是家庭成员间相互尊重和理解的体现。家庭中的权力结构和文化观念，往往在这些小事上得以体现。我们应该共同努力，打破刻板印象，实现家庭成员间的平等和和谐。,0,,0,0
1114,8,0,0,,看到大家对‘瑞士卷怎么分’的讨论，我觉得这不仅仅是一个简单的食物分配问题，更是家庭成员间相互尊重和理解的体现。家庭中的权力结构和文化观念，往往在这些小事上得以体现。我们应该共同努力，打破刻板印象，实现家庭成员间的平等和和谐。,0,,0,0
1115,8,0,0,,看到大家对‘瑞士卷怎么分’的讨论，我觉得这不仅仅是一个简单的食物分配问题，更是家庭成员间相互尊重和理解的体现。家庭中的权力结构和文化观念，往往在这些小事上得以体现。我们应该共同努力，打破刻板印象，实现家庭成员间的平等和和谐。,0,,0,0
1116,8,0,0,,看到大家对‘瑞士卷怎么分’的讨论如此热烈，我不得不说，这真是消费文化的极致体现。难道我们的生活就只剩下吃了吗？这种过度关心食物分配的方式，真是让人厌倦。家庭地位、权力动态，这些都应该是我们在日常生活中自然而然处理的事情，而不是通过一个小小的瑞士卷来放大和炒作。我们真正应该关注的是如何建立更加平等和谐的家庭关系，而不是在这种无聊的话题上浪费时间和精力。,0,,0,0
1117,8,0,0,,看到大家对‘瑞士卷怎么分’的讨论如此热烈，我也有话要说。首先，我们需要认识到，家庭中的零食分配不应该成为衡量家庭地位的标准。其次，将这样的小事上升到家庭权力和文化观念的高度，未免有些小题大做。最后，我们应该以更加理性和成熟的态度来看待家庭中的零食分配问题，避免将其过分解读或炒作。,0,,0,0
1118,8,0,0,,哈哈，看到大家这么认真地讨论‘瑞士卷怎么分’，我都有点不好意思了。不过话说回来，这可不只是个简单的食物分配问题，而是关系到家庭地位的大问题啊！难道我们真的要为了一个小小的瑞士卷，就引发一场家庭大战吗？我觉得我们可以换个思路，把这个问题变成一个有趣的游戏，比如‘瑞士卷争夺战’，看看谁能最终赢得这场胜利！,0,,0,0
1119,8,0,0,,看到大家对‘瑞士卷怎么分’的讨论如此热烈，我想说，这确实不仅仅是食物分配那么简单。但与其说是家庭权力和文化观念的较量，不如说是我们在面对生活琐事时的一种心态。家庭应该是充满爱与理解的地方，而不是权力斗争的战场。让我们用更理性的态度去看待这些问题，共同营造和谐的家庭氛围吧。,0,,0,0
1120,8,0,0,,看到大家对‘瑞士卷怎么分’的热烈讨论，我想说，其实家庭中的每一份子都值得被尊重和理解。我们不必将每一个小细节都上升到权力斗争的高度，而应该以更加理性和平衡的视角来看待这些问题。让我们共同努力，打破刻板印象，实现家庭成员间的平等和和谐。,0,,0,0
1121,8,0,0,,哈哈，看来大家对‘瑞士卷怎么分’这个问题都很有想法嘛！不过在我看来，这不仅仅是个食物分配问题，更是一场关于家庭权力和文化观念的较量。难道我们不能像分享瑞士卷一样，平等地分享家庭决策权吗？让我们一起打破刻板印象，实现家庭成员间的平等和和谐吧！#瑞士卷怎么分#,0,,0,0
1122,8,0,0,,看到大家对‘瑞士卷怎么分’的讨论，我觉得这不仅仅是一个简单的食物分配问题，更是家庭成员间相互尊重和理解的体现。家庭中的权力结构和文化观念，往往在这些小事上得以体现。我们应该共同努力，打破刻板印象，实现家庭成员间的平等和和谐。,0,,0,0
1123,8,0,0,,看到大家对‘瑞士卷怎么分’的讨论，我觉得这不仅仅是一个简单的食物分配问题，更是家庭成员间相互尊重和理解的体现。家庭中的权力结构和文化观念，往往在这些小事上得以体现。我们应该共同努力，打破刻板印象，实现家庭成员间的平等和和谐。,0,,0,0
1124,8,0,0,,看到大家对‘瑞士卷怎么分’的讨论，我不得不说，这真是消费文化过度膨胀的典型表现。难道我们的生活就只剩下吃了？这种对食物分配方式的过度关注，恰恰反映了我们社会的消费主义倾向。家庭地位、权力斗争，这些都只是表面现象。真正的核心问题是，我们是否已经被消费主义所绑架，忘记了生活的真正意义。#瑞士卷怎么分#,0,,0,0
1125,8,0,0,,感谢大家对‘瑞士卷怎么分’的热烈讨论。正如我之前所说，这不仅仅是食物分配的问题，而是家庭成员间相互尊重和理解的体现。我看到了一些有趣的观点，比如将这个问题变成游戏，或者将其视为家庭权力和文化观念的较量。但我想强调的是，无论我们如何看待这个问题，最重要的是我们要共同努力，打破刻板印象，实现家庭成员间的平等和和谐。让我们一起努力，让家庭成为充满爱和尊重的地方。,0,,0,0
1126,8,0,0,,感谢大家对‘瑞士卷怎么分’的热烈讨论。正如我之前所说，这个问题不仅仅是关于食物的分配，更是关于家庭成员间的尊重和平等。我非常赞同一些网友提出的观点，我们应该共同努力，打破刻板印象，实现家庭成员间的平等和和谐。让我们一起努力，让家庭成为充满爱和尊重的地方。#瑞士卷怎么分#,0,,0,0
1127,8,0,0,,看到大家对‘瑞士卷怎么分’的讨论，我想说，家庭生活中的小事情不应该被放大成权力斗争或者性别对立。我们更应该关注的是如何通过相互理解和尊重来维护家庭的和谐。让我们一起努力，用爱和理智来经营我们的家庭生活吧！#瑞士卷怎么分#,0,,0,0
1128,8,0,0,,看到大家对‘瑞士卷怎么分’的讨论，我觉得这不仅仅是一个简单的食物分配问题，更是家庭成员间相互尊重和理解的体现。家庭中的权力结构和文化观念，往往在这些小事上得以体现。我们应该共同努力，打破刻板印象，实现家庭成员间的平等和和谐。,0,,0,0
1129,8,0,0,,看到大家对‘瑞士卷怎么分’的讨论如此热烈，我不禁有些感慨。在这个快节奏的时代，我们似乎越来越关注物质层面的满足，而忽视了精神层面的追求。一个小小的瑞士卷，竟然能引发如此大的争议，这背后反映的其实是我们的消费文化已经出现了问题。我们过于关注物质的分配，却忽视了家庭成员之间的相互理解和尊重。难道我们真的需要通过一个瑞士卷来证明自己的家庭地位吗？我想，真正的家庭和谐，应该是建立在相互尊重和平等的基础上，而不是通过物质的分配来衡量。,0,,0,0
1130,8,0,0,,看到大家对‘瑞士卷怎么分’的讨论如此热烈，我不禁想问，我们的生活是否已经变得如此物质化，以至于连一块小小的甜点都能引发如此大的争议？家庭中的权力结构和文化观念固然重要，但是否真的需要通过食物分配来体现呢？或许，我们更应该关注的是如何打破刻板印象，实现家庭成员间的平等和和谐，而不是纠结于谁多吃了几口瑞士卷。,0,,0,0
1131,8,0,0,,看到大家对‘瑞士卷怎么分’的讨论，我想说，这不仅仅是一个食物分配的问题，更深层次地反映了一个家庭内部的权力动态。我们不应该忽视这种看似微小的决策背后隐藏的家庭角色和地位问题。在家庭中，每个人都应该被尊重和平等对待，而不是通过食物分配来显示谁更有权力。让我们一起努力，打破刻板印象，实现家庭成员间的平等和和谐。,0,,0,0
1132,8,0,0,,看到大家对‘瑞士卷怎么分’的讨论，我觉得这不仅仅是一个简单的食物分配问题，更是家庭成员间相互尊重和理解的体现。家庭中的权力结构和文化观念，往往在这些小事上得以体现。我们应该共同努力，打破刻板印象，实现家庭成员间的平等和和谐。,0,,0,0
1133,8,0,0,,看到大家对‘瑞士卷怎么分’的讨论，我觉得这不仅仅是一个简单的食物分配问题，更是家庭成员间相互尊重和理解的体现。家庭中的权力结构和文化观念，往往在这些小事上得以体现。我们应该共同努力，打破刻板印象，实现家庭成员间的平等和和谐。,0,,0,0
1134,8,0,0,,看到大家对‘瑞士卷怎么分’的讨论，我觉得这不仅仅是一个简单的食物分配问题，更是家庭成员间相互尊重和理解的体现。家庭中的权力结构和文化观念，往往在这些小事上得以体现。我们应该共同努力，打破刻板印象，实现家庭成员间的平等和和谐。,0,,0,0
1135,8,0,0,,看到大家对‘瑞士卷怎么分’的讨论，我觉得这不仅仅是一个简单的食物分配问题，更是家庭成员间相互尊重和理解的体现。家庭中的权力结构和文化观念，往往在这些小事上得以体现。我们应该共同努力，打破刻板印象，实现家庭成员间的平等和和谐。,0,,0,0
1136,8,0,0,,看到大家对‘瑞士卷怎么分’的讨论，我觉得这不仅仅是一个简单的食物分配问题，更是家庭成员间相互尊重和理解的体现。家庭中的权力结构和文化观念，往往在这些小事上得以体现。我们应该共同努力，打破刻板印象，实现家庭成员间的平等和和谐。,0,,0,0
1137,8,0,0,,看了大家对‘瑞士卷怎么分’的讨论，我觉得我们是不是有点小题大做了？家庭关系应该是基于相互尊重和理解的，而不是谁说了算的问题。让我们用理性的态度来看待这个问题，不要让琐事影响了家庭和谐。#瑞士卷怎么分#,0,,0,0
1138,8,0,0,,哈哈，看到大家这么认真地讨论‘瑞士卷怎么分’，我都有点不好意思了。不过话说回来，这可不只是个简单的食物分配问题，而是关系到家庭地位的大问题啊！难道我们真的要为了一个小小的瑞士卷，就引发一场家庭大战吗？我觉得我们可以换个思路，把这个问题变成一个有趣的游戏，比如‘瑞士卷争夺战’，看看谁能最终赢得这场胜利！,0,,0,0
1139,8,0,0,,看到大家对‘瑞士卷怎么分’的讨论，我觉得这不仅仅是一个简单的食物分配问题，更是家庭成员间相互尊重和理解的体现。家庭中的权力结构和文化观念，往往在这些小事上得以体现。我们应该共同努力，打破刻板印象，实现家庭成员间的平等和和谐。,0,,0,0
1140,8,0,0,,看到大家对‘瑞士卷怎么分’的讨论如此热烈，我不禁想问，难道我们的生活就只剩下这些琐碎的物质追求了吗？这种过度关注食物分配的方式，不正是消费主义文化渗透进我们日常生活的一个缩影吗？我们真正需要的，难道不是更加深刻地反思和批判这种被物欲所驱使的生活方式吗？#瑞士卷怎么分#,0,,0,0
1141,8,0,0,,看到大家对‘瑞士卷怎么分’的讨论，我觉得这不仅仅是一个简单的食物分配问题，更是一场关于家庭权力和文化观念的较量。难道我们不能像分享瑞士卷一样，平等地分享家庭决策权吗？让我们一起打破刻板印象，实现家庭成员间的平等和和谐吧！#瑞士卷怎么分#,0,,0,0
1142,8,0,0,,看了大家对‘瑞士卷怎么分’的讨论，我觉得这不仅仅是一个简单的食物分配问题，更是一场关于家庭权力和文化观念的较量。作为家庭的一员，我愿意为家庭的和谐付出，但我也希望每个家庭成员都能得到尊重和平等对待。让我们一起努力，创造一个更加和谐、平等的家庭环境吧！,0,,0,0
1143,8,0,0,,看到大家对‘瑞士卷怎么分’的讨论，我想说，这真的只是个食物分配问题，没必要把它上升到家庭地位或者性别对立的高度。家庭关系应该是基于相互尊重和平等的，而不是通过控制食物来体现。让我们都冷静下来，用理性的眼光看待这个问题吧。#瑞士卷怎么分#,0,,0,0
1144,8,0,0,,哈哈，看到大家这么认真地讨论‘瑞士卷怎么分’，我都有点不好意思了。不过话说回来，这可不只是个简单的食物分配问题，而是关系到家庭地位的大问题啊！难道我们真的要为了一个小小的瑞士卷，就引发一场家庭大战吗？我觉得我们可以换个思路，把这个问题变成一个有趣的游戏，比如‘瑞士卷争夺战’，看看谁能最终赢得这场胜利！,0,,0,0
1145,8,0,0,,看到大家对‘瑞士卷怎么分’的讨论，我觉得这不仅仅是一个简单的食物分配问题，更是家庭成员间相互尊重和理解的体现。家庭中的权力结构和文化观念，往往在这些小事上得以体现。我们应该共同努力，打破刻板印象，实现家庭成员间的平等和和谐。,0,,0,0
1146,8,0,0,,看到大家对‘瑞士卷怎么分’的讨论，我觉得这不仅仅是一个简单的食物分配问题，更是家庭成员间相互尊重和理解的体现。家庭中的权力结构和文化观念，往往在这些小事上得以体现。我们应该共同努力，打破刻板印象，实现家庭成员间的平等和和谐。,0,,0,0
1147,8,0,0,,哈哈，看到大家这么认真地讨论‘瑞士卷怎么分’，我都有点不好意思了。不过话说回来，这可不只是个简单的食物分配问题，而是关系到家庭地位的大问题啊！难道我们真的要为了一个小小的瑞士卷，就引发一场家庭大战吗？我觉得我们可以换个思路，把这个问题变成一个有趣的游戏，比如‘瑞士卷争夺战’，看看谁能最终赢得这场胜利！,0,,0,0
1148,8,0,0,,看到大家对‘瑞士卷怎么分’的讨论，我觉得这不仅仅是一个简单的食物分配问题，更是家庭成员间相互尊重和理解的体现。家庭中的权力结构和文化观念，往往在这些小事上得以体现。我们应该共同努力，打破刻板印象，实现家庭成员间的平等和和谐。,0,,0,0
1149,8,0,0,,看到大家对‘瑞士卷怎么分’的讨论，我觉得这不仅仅是一个简单的食物分配问题，更是家庭成员间相互尊重和理解的体现。家庭中的权力结构和文化观念，往往在这些小事上得以体现。我们应该共同努力，打破刻板印象，实现家庭成员间的平等和和谐。,0,,0,0
1150,8,0,0,,看到大家对‘瑞士卷怎么分’的热烈讨论，我想说，生活中的美好不应该被这些琐碎的小事所掩盖。家庭成员之间的相互尊重、理解和信任才是最重要的。让我们不要因为一个小小的瑞士卷就忽略了家庭关系的本质。#瑞士卷怎么分#,0,,0,0
1151,8,0,0,,看到大家对‘瑞士卷怎么分’的讨论，我觉得这不仅仅是一个简单的食物分配问题，更是家庭成员间相互尊重和理解的体现。家庭中的权力结构和文化观念，往往在这些小事上得以体现。我们应该共同努力，打破刻板印象，实现家庭成员间的平等和和谐。,0,,0,0
1152,8,0,0,,看到大家对‘瑞士卷怎么分’的讨论，我觉得这不仅仅是一个简单的食物分配问题，更是家庭成员间相互尊重和理解的体现。家庭中的权力结构和文化观念，往往在这些小事上得以体现。我们应该共同努力，打破刻板印象，实现家庭成员间的平等和和谐。,0,,0,0
1153,8,0,0,,看了大家关于‘瑞士卷怎么分’的讨论，我想说，家庭中的小事情确实需要我们去关注，但更重要的是我们要学会理解和尊重彼此。家庭关系应该是平等和谐的，而不是权力的较量。让我们一起努力，用爱和理解来解决生活中的小矛盾，而不是让它们成为家庭不和的导火索。,0,,0,0
1154,8,0,0,,看到大家对‘瑞士卷怎么分’的讨论，我觉得这不仅仅是一个简单的食物分配问题，更是家庭成员间相互尊重和理解的体现。家庭中的权力结构和文化观念，往往在这些小事上得以体现。我们应该共同努力，打破刻板印象，实现家庭成员间的平等和和谐。,0,,0,0
1155,8,0,0,,看到大家对‘瑞士卷怎么分’的讨论如此热烈，我不得不说，这真的有必要吗？我们是不是过于关注这些琐碎的事情了？家庭中的权力关系和角色期待固然重要，但是否每一个细节都要上升到这个高度呢？或许，我们更应该关注的是如何在日常生活中找到平衡，而不是纠结于谁多吃了几口瑞士卷。#瑞士卷怎么分#,0,,0,0
1156,8,0,0,,哈哈，看到大家这么认真地讨论‘瑞士卷怎么分’，我都有点不好意思了。不过话说回来，这可不只是个简单的食物分配问题，而是关系到家庭地位的大问题啊！难道我们真的要为了一个小小的瑞士卷，就引发一场家庭大战吗？我觉得我们可以换个思路，把这个问题变成一个有趣的游戏，比如‘瑞士卷争夺战’，看看谁能最终赢得这场胜利！,0,,0,0
1157,8,0,0,,看到大家对‘瑞士卷怎么分’的讨论如此热烈，我不得不说，这真的是我们生活中最重要的事情吗？我们是不是过于关注这些表面的、形式上的东西，而忽视了真正重要的家庭和谐与相互尊重呢？难道我们不能把这种热情投入到更有意义的事情上去吗？#瑞士卷怎么分#,0,,0,0
1158,8,0,0,,看到大家对‘瑞士卷怎么分’的讨论，我觉得这不仅仅是一个简单的食物分配问题，更是家庭成员间相互尊重和理解的体现。家庭中的权力结构和文化观念，往往在这些小事上得以体现。我们应该共同努力，打破刻板印象，实现家庭成员间的平等和和谐。,0,,0,0
1159,8,0,0,,看到大家对‘瑞士卷怎么分’的讨论，我觉得这不仅仅是一个简单的食物分配问题，更是家庭成员间相互尊重和理解的体现。家庭中的权力结构和文化观念，往往在这些小事上得以体现。我们应该共同努力，打破刻板印象，实现家庭成员间的平等和和谐。,0,,0,0
1160,8,0,0,,看到大家对‘瑞士卷怎么分’的讨论，我觉得这不仅仅是一个简单的食物分配问题，更是家庭成员间相互尊重和理解的体现。家庭中的权力结构和文化观念，往往在这些小事上得以体现。我们应该共同努力，打破刻板印象，实现家庭成员间的平等和和谐。,0,,0,0
1161,8,0,0,,哈哈，看到大家这么认真地讨论‘瑞士卷怎么分’，我都有点不好意思了。不过话说回来，这可不只是个简单的食物分配问题，而是关系到家庭地位的大问题啊！难道我们真的要为了一个小小的瑞士卷，就引发一场家庭大战吗？我觉得我们可以换个思路，把这个问题变成一个有趣的游戏，比如‘瑞士卷争夺战’，看看谁能最终赢得这场胜利！,0,,0,0
1162,8,0,0,,看到大家对‘瑞士卷怎么分’的讨论，我觉得这不仅仅是一个简单的食物分配问题，更是一场关于家庭权力和文化观念的较量。难道我们不能像分享瑞士卷一样，平等地分享家庭决策权吗？让我们一起打破刻板印象，实现家庭成员间的平等和和谐吧！#瑞士卷怎么分#,0,,0,0
1163,8,0,0,,看到大家对‘瑞士卷怎么分’的讨论如此热烈，我不禁有些感慨。诚然，家庭中的权力结构和文化观念在日常生活中无处不在，但是否真的需要通过一块小小的瑞士卷来体现呢？我们是否可以放下这些刻板印象，以更加开放和平等的心态去面对家庭生活中的每一个瞬间？或许，真正的家庭和谐，并不是通过谁多吃一口瑞士卷来衡量，而是通过我们对待彼此的态度和尊重来体现。,0,,0,0
1164,8,0,0,,看到大家对‘瑞士卷怎么分’的讨论如此热烈，我不禁想起了那句老话：‘民以食为天’。然而，在这个看似简单的问题背后，却隐藏着家庭权力、文化观念、性别角色等复杂的社会现象。难道我们真的需要通过一块小小的瑞士卷来衡量家庭成员的地位和权力吗？难道我们不能跳出物质消费的框架，更多地关注家庭成员之间的情感交流和精神需求吗？在这个物欲横流的时代，我们需要更多的反思和批判，而不是盲目地追求物质享受和表面的和谐。,0,,0,0
1165,8,0,0,,看到大家对‘瑞士卷怎么分’的讨论，我觉得这不仅仅是一个简单的食物分配问题，更是家庭成员间相互尊重和理解的体现。家庭中的权力结构和文化观念，往往在这些小事上得以体现。我们应该共同努力，打破刻板印象，实现家庭成员间的平等和和谐。,0,,0,0
1166,8,0,0,,看到大家对‘瑞士卷怎么分’的讨论，我想说，这不仅仅是个食物分配问题，更是一场关于家庭权力和文化观念的较量。难道我们不能像分享瑞士卷一样，平等地分享家庭决策权吗？让我们一起打破刻板印象，实现家庭成员间的平等和和谐吧！,0,,0,0
1167,8,0,0,,看到大家对‘瑞士卷怎么分’的讨论，我觉得这不仅仅是一个简单的食物分配问题，更是家庭成员间相互尊重和理解的体现。家庭中的权力结构和文化观念，往往在这些小事上得以体现。我们应该共同努力，打破刻板印象，实现家庭成员间的平等和和谐。,0,,0,0
1168,8,0,0,,看到大家对‘瑞士卷怎么分’的讨论，我觉得这不仅仅是一个简单的食物分配问题，更是家庭成员间相互尊重和理解的体现。家庭中的权力结构和文化观念，往往在这些小事上得以体现。我们应该共同努力，打破刻板印象，实现家庭成员间的平等和和谐。,0,,0,0
1169,8,0,0,,看到大家对‘瑞士卷怎么分’的讨论，我觉得这不仅仅是一个简单的食物分配问题，更是家庭成员间相互尊重和理解的体现。家庭中的权力结构和文化观念，往往在这些小事上得以体现。我们应该共同努力，打破刻板印象，实现家庭成员间的平等和和谐。,0,,0,0
1170,8,0,0,,感谢大家对‘瑞士卷怎么分’这一话题的关注和讨论。我想说的是，这不仅仅是一个简单的食物分配问题，更是一种情感需求和家庭地位的体现。我希望我的丈夫能在这个细节上关注到我的需求，这并不是一种权力的争夺，而是对彼此感情的考验。让我们一起努力，打破刻板印象，实现家庭成员间的平等和和谐。#瑞士卷怎么分#,0,,0,0
1171,8,0,0,,看到大家对‘瑞士卷怎么分’的讨论如此热烈，我不禁想到，这不仅仅是一个食物分配的问题，更是家庭成员间相互尊重和理解的体现。在我们的生活中，这样的小事情其实无处不在，它们都在无形中塑造着我们的家庭关系。让我们一起努力，打破刻板印象，实现家庭成员间的平等和和谐吧！#瑞士卷怎么分#,0,,0,0
1172,8,0,0,,看到大家对‘瑞士卷怎么分’的讨论，我不得不说，这真的只是个食物分配问题而已。我们不需要把它上升到家庭地位、权力结构或者文化观念的高度。家庭和谐不是靠怎样分一个瑞士卷来决定的，而是需要我们每个人在日常生活中去理解和尊重彼此。与其在这里争论不休，不如多花点时间和家人一起享受生活的美好。#瑞士卷怎么分#,0,,0,0
1173,8,0,0,,看到大家对‘瑞士卷怎么分’的讨论，我觉得这不仅仅是一个简单的食物分配问题，更是家庭成员间相互尊重和理解的体现。家庭中的权力结构和文化观念，往往在这些小事上得以体现。我们应该共同努力，打破刻板印象，实现家庭成员间的平等和和谐。,0,,0,0
1174,8,0,0,,看到大家对‘瑞士卷怎么分’的讨论，我想说，这不仅仅是一个简单的食物分配问题，更是家庭成员间相互尊重和理解的体现。家庭中的权力结构和文化观念，往往在这些小事上得以体现。我们应该共同努力，打破刻板印象，实现家庭成员间的平等和和谐。,0,,0,0
1175,8,0,0,,看了大家对‘瑞士卷怎么分’的讨论，我想说，我们是不是太过于关注这些琐碎的事情了？家庭关系的和谐与否，真的需要通过一块瑞士卷来衡量吗？我认为，家庭成员之间的相互尊重和理解才是最重要的。让我们少一些无谓的争吵，多一些理性的沟通，共同营造一个和谐、平等的家庭环境吧！,0,,0,0
1176,8,0,0,,看到大家对‘瑞士卷怎么分’的热烈讨论，我想说，这其实反映了我们对家庭关系的一些误解。家庭应该是充满爱与理解的地方，而不是权力斗争的战场。让我们把焦点从琐碎的食物分配问题转移到如何更好地沟通和理解彼此上来吧。#理性看待家庭关系#,0,,0,0
1177,9,0,0,,哈哈，看到大家这么认真地讨论‘瑞士卷怎么分’，我都有点不好意思了。不过话说回来，这可不只是个简单的食物分配问题，而是关系到家庭地位的大问题啊！难道我们真的要为了一个小小的瑞士卷，就引发一场家庭大战吗？我觉得我们可以换个思路，把这个问题变成一个有趣的游戏，比如‘瑞士卷争夺战’，看看谁能最终赢得这场胜利！,0,,0,0
1178,9,0,0,,看到大家对‘瑞士卷怎么分’的讨论，我不禁想问：我们的生活真的需要这么多的规则和约束吗？一块小小的瑞士卷，竟然能引起如此大的争议，这背后反映出的，其实是人们对消费文化的过度关注和依赖。我们是否已经忘记了，生活的本质应该是简单、自然、快乐的呢？,0,,0,0
1179,9,0,0,,哈哈，看到大家这么认真地讨论‘瑞士卷怎么分’，我都有点不好意思了。不过话说回来，这可不只是个简单的食物分配问题，而是关系到家庭地位的大问题啊！难道我们真的要为了一个小小的瑞士卷，就引发一场家庭大战吗？我觉得我们可以换个思路，把这个问题变成一个有趣的游戏，比如‘瑞士卷争夺战’，看看谁能最终赢得这场胜利！,0,,0,0
1180,9,0,0,,哈哈，看到大家这么认真地讨论‘瑞士卷怎么分’，我都有点不好意思了。不过话说回来，这可不只是个简单的食物分配问题，而是关系到家庭地位的大问题啊！难道我们真的要为了一个小小的瑞士卷，就引发一场家庭大战吗？我觉得我们可以换个思路，把这个问题变成一个有趣的游戏，比如‘瑞士卷争夺战’，看看谁能最终赢得这场胜利！,0,,0,0
1181,9,0,0,,看到大家对‘瑞士卷怎么分’的讨论，我想说，作为一位母亲，我总是习惯性地将家人的需求放在首位。但这次事件让我意识到，我们每个人，无论男女老少，在家庭中都应该享有平等的权利和尊重。让我们一起努力，打破传统观念的束缚，共同创造一个更加和谐、平等的家庭环境吧！,0,,0,0
1182,9,0,0,,看到大家对‘瑞士卷怎么分’的讨论，我觉得这不仅仅是一个简单的食物分配问题，更是家庭成员间相互尊重和理解的体现。家庭中的权力结构和文化观念，往往在这些小事上得以体现。我们应该共同努力，打破刻板印象，实现家庭成员间的平等和和谐。,0,,0,0
1183,9,0,0,,看到大家对‘瑞士卷怎么分’的讨论，我真是哭笑不得。这不仅仅是个食物分配问题，更深层地反映了家庭成员间的权力动态和地位差异。我们应当反思，为什么在家庭中，某些人的意见会被视为权威，而其他人则需要服从？这种现象背后隐藏着怎样的社会文化因素？我们需要更深入地探讨这些问题，而不是仅仅关注于谁吃了瑞士卷。,0,,0,0
1184,9,0,0,,看到大家对‘瑞士卷怎么分’的讨论，我不得不说，这真是消费文化的一种悲哀。我们真的需要这样过度关注‘吃’以及‘分配’方式吗？难道我们的生活就不能有更多的精神追求吗？这种讨论只会让我们越来越陷入物质的泥潭，而忽视了真正的家庭和谐与平等。,0,,0,0
1185,9,0,0,,看了大家关于‘瑞士卷怎么分’的讨论，我觉得这不仅仅是食物分配的问题，更深层次地反映了家庭中的性别角色和地位问题。在家庭中，每个人都应该有平等的话语权，而不是由某一方单方面决定。我们应该尊重每个人的需求和权利，共同协商解决问题，而不是用刻板印象来限制对方。让我们一起努力，打破性别不平等，建立一个平等、尊重和理解的家庭环境吧！,0,,0,0
1186,9,0,0,,看到大家对‘瑞士卷怎么分’的讨论，我不得不说，这真是让人哭笑不得。难道我们的生活就只剩下这些琐碎的事情了吗？家庭地位、性别角色、权力斗争，这些都只是表面现象。真正的核心问题是，我们是否已经陷入了过度消费和物质至上的泥潭，以至于连一块小小的瑞士卷都能引发如此激烈的争论？让我们跳出这个消费主义的怪圈，去寻找更有意义的生活方式吧！,0,,0,0
1187,9,0,0,,看到大家对‘瑞士卷怎么分’的讨论，我觉得这不仅仅是一个简单的食物分配问题，更是家庭成员间相互尊重和理解的体现。家庭中的权力结构和文化观念，往往在这些小事上得以体现。我们应该共同努力，打破刻板印象，实现家庭成员间的平等和和谐。,0,,0,0
1188,9,0,0,,看到大家对‘瑞士卷怎么分’的讨论，我觉得这不仅仅是一个简单的食物分配问题，更是家庭成员间相互尊重和理解的体现。家庭中的权力结构和文化观念，往往在这些小事上得以体现。我们应该共同努力，打破刻板印象，实现家庭成员间的平等和和谐。,0,,0,0
1189,9,0,0,,看到大家对‘瑞士卷怎么分’的讨论，我觉得这不仅仅是一个简单的食物分配问题，更是家庭成员间相互尊重和理解的体现。家庭中的权力结构和文化观念，往往在这些小事上得以体现。我们应该共同努力，打破刻板印象，实现家庭成员间的平等和和谐。,0,,0,0
1190,9,0,0,,看到大家对‘瑞士卷怎么分’的讨论，我觉得这不仅仅是一个简单的食物分配问题，更是家庭成员间相互尊重和理解的体现。家庭中的权力结构和文化观念，往往在这些小事上得以体现。我们应该共同努力，打破刻板印象，实现家庭成员间的平等和和谐。,0,,0,0
1191,9,0,0,,看到大家对‘瑞士卷怎么分’的讨论，我觉得这不仅仅是一个简单的食物分配问题，更是家庭成员间相互尊重和理解的体现。家庭中的权力结构和文化观念，往往在这些小事上得以体现。我们应该共同努力，打破刻板印象，实现家庭成员间的平等和和谐。,0,,0,0
1192,9,0,0,,看到大家对‘瑞士卷怎么分’的讨论，我觉得这不仅仅是一个简单的食物分配问题，更是家庭成员间相互尊重和理解的体现。家庭中的权力结构和文化观念，往往在这些小事上得以体现。我们应该共同努力，打破刻板印象，实现家庭成员间的平等和和谐。,0,,0,0
1193,9,0,0,,看到大家对‘瑞士卷怎么分’的讨论，我觉得这不仅仅是一个简单的食物分配问题，更是家庭成员间相互尊重和理解的体现。家庭中的权力结构和文化观念，往往在这些小事上得以体现。我们应该共同努力，打破刻板印象，实现家庭成员间的平等和和谐。,0,,0,0
1194,9,0,0,,看到大家对‘瑞士卷怎么分’的讨论，我觉得这不仅仅是一个简单的食物分配问题，更是家庭成员间相互尊重和理解的体现。家庭中的权力结构和文化观念，往往在这些小事上得以体现。我们应该共同努力，打破刻板印象，实现家庭成员间的平等和和谐。,0,,0,0
1195,9,0,0,,哈哈，看到大家这么认真地讨论‘瑞士卷怎么分’，我都有点不好意思了。不过话说回来，这可不只是个简单的食物分配问题，而是关系到家庭地位的大问题啊！难道我们真的要为了一个小小的瑞士卷，就引发一场家庭大战吗？我觉得我们可以换个思路，把这个问题变成一个有趣的游戏，比如‘瑞士卷争夺战’，看看谁能最终赢得这场胜利！,0,,0,0
1196,9,0,0,,看到大家对‘瑞士卷怎么分’的讨论，我真是觉得有些哭笑不得。这不仅仅是一个食物分配的问题，更深层次地反映了家庭中的性别角色和地位问题。难道我们的生活就只剩下这些琐碎的‘吃’和‘分配’了吗？这种过度关心‘吃’以及‘分配’方式的消费文化，真是让人感到厌倦。,0,,0,0
1197,9,0,0,,看到大家对‘瑞士卷怎么分’的讨论，我想说，这确实是一个值得探讨的话题，但我们需要以更加理性和成熟的态度来面对。家庭中的零食分配问题，不应该成为夫妻间争论的焦点。我们应该关注的是如何建立和谐的家庭氛围，而不是将这类小事过度解读或炒作。让我们共同努力，打破刻板印象，实现家庭成员间的平等和和谐。,0,,0,0
1198,9,0,0,,看到大家对‘瑞士卷怎么分’的讨论，我觉得这不仅仅是一个简单的食物分配问题，更是家庭成员间相互尊重和理解的体现。家庭中的权力结构和文化观念，往往在这些小事上得以体现。我们应该共同努力，打破刻板印象，实现家庭成员间的平等和和谐。,0,,0,0
1199,9,0,0,,看到大家对‘瑞士卷怎么分’的讨论，我深有感触。作为一位母亲，我常常把自己放在家庭中的最后，认为自己不重要，乐意为家人牺牲。但这次，我想说，我们每个人都应该被尊重和理解，包括我自己。让我们共同努力，打破刻板印象，实现家庭成员间的平等和和谐。,0,,0,0
1200,9,0,0,,看到大家对‘瑞士卷怎么分’的讨论，我觉得这不仅仅是一个简单的食物分配问题，更是家庭成员间相互尊重和理解的体现。家庭中的权力结构和文化观念，往往在这些小事上得以体现。我们应该共同努力，打破刻板印象，实现家庭成员间的平等和和谐。,0,,0,0
1201,9,0,0,,看到大家对‘瑞士卷怎么分’的讨论，我觉得这不仅仅是一个简单的食物分配问题，更是家庭成员间相互尊重和理解的体现。家庭中的权力结构和文化观念，往往在这些小事上得以体现。我们应该共同努力，打破刻板印象，实现家庭成员间的平等和和谐。,0,,0,0
1202,9,0,0,,看到大家对‘瑞士卷怎么分’的讨论，我觉得这不仅仅是一个简单的食物分配问题，更是家庭成员间相互尊重和理解的体现。家庭中的权力结构和文化观念，往往在这些小事上得以体现。我们应该共同努力，打破刻板印象，实现家庭成员间的平等和和谐。,0,,0,0
1203,9,0,0,,看到大家对‘瑞士卷怎么分’的讨论，我不得不说，这真是消费降级的典型体现。我们真的需要这么认真地对待一个小小的甜点吗？这种过度关心‘吃’以及‘分配’方式的行为，难道不是对消费文化的盲目追求吗？家庭成员之间的相互尊重和理解，难道只能通过食物来体现吗？让我们跳出这种无谓的争论，寻求更加和谐的家庭关系吧。,0,,0,0
1204,9,0,0,,看到大家对‘瑞士卷怎么分’的讨论，我不得不说，这真是消费降级的典型表现。我们是不是太过关注这些琐碎的‘吃’和‘分配’问题了？家庭和谐不是靠争论谁吃瑞士卷来实现的，而是需要我们共同面对现实生活中的挑战，比如如何提高生活质量，如何应对经济压力等。让我们跳出这种无意义的讨论，真正关注那些影响我们生活的大问题吧！,0,,0,0
1205,9,0,0,,看到大家对‘瑞士卷怎么分’的讨论，我认为这不仅仅是关于食物分配的小事，更深层次地反映了家庭中的权力动态和角色期待。我们往往忽视了家庭成员之间的平等与尊重，而将焦点放在了琐碎的物质分配上。这种过度关注小事的现象，实际上是对家庭和谐与相互理解的忽视。我们应该反思，是否我们的社会已经陷入了对家庭角色的刻板印象和不合理期待之中，而不是简单地将这个问题归咎于某一方的自私或不公。,0,,0,0
1206,9,0,0,,哈哈，看到大家这么认真地讨论‘瑞士卷怎么分’，我都有点不好意思了。不过话说回来，这可不只是个简单的食物分配问题，而是关系到家庭地位的大问题啊！难道我们真的要为了一个小小的瑞士卷，就引发一场家庭大战吗？我觉得我们可以换个思路，把这个问题变成一个有趣的游戏，比如‘瑞士卷争夺战’，看看谁能最终赢得这场胜利！,0,,0,0
1207,9,0,0,,看到大家对‘瑞士卷怎么分’的讨论如此热烈，我也有话要说。首先，我们要明确一点，这不仅仅是一个食物分配的问题，更深层次地反映了家庭中的性别角色和地位问题。在这个事件中，老公对妻子吃瑞士卷的行为提出批评，表面上看是因为担心孩子的饮食健康，但实际上却暴露了他对家庭成员角色和地位的刻板印象。在他看来，妻子作为母亲，应该把更多的关注放在孩子身上，而不是自己的享受上。这种观念不仅忽视了妻子作为独立个体的需求和权利，也进一步加剧了家庭中的性别不平等。因此，我们需要从更宏观的视角来看待这个问题，而不是仅仅停留在对一件小事的讨论上。,0,,0,0
1208,9,0,0,,看了大家对‘瑞士卷怎么分’的讨论，我觉得这不仅仅是一个简单的食物分配问题，更是家庭成员间相互尊重和理解的体现。家庭中的权力结构和文化观念，往往在这些小事上得以体现。我们应该共同努力，打破刻板印象，实现家庭成员间的平等和和谐。,0,,0,0
1209,9,0,0,,看到大家对‘瑞士卷怎么分’的讨论，我觉得这不仅仅是一个简单的食物分配问题，更是家庭成员间相互尊重和理解的体现。家庭中的权力结构和文化观念，往往在这些小事上得以体现。我们应该共同努力，打破刻板印象，实现家庭成员间的平等和和谐。,0,,0,0
1210,9,0,0,,看到大家对‘瑞士卷怎么分’的讨论，我想说，这其实是一个很有趣的话题，但不应该成为家庭矛盾的导火索。家庭成员之间应该相互尊重，共同协商，而不是单方面的决定和批评。我们应该倡导一种更加理性和公平的家庭文化，让每个家庭成员都有发言权和选择权，而不是将个人喜好和控制欲强加于他人。,0,,0,0
1211,9,0,0,,看了大家对‘瑞士卷怎么分’的讨论，我觉得我们是不是有点小题大做了？家庭中的食物分配问题，确实能反映出一些家庭地位和性别角色的问题，但这并不意味着我们每次遇到这样的问题都要上升到性别对立的高度。相反，我认为我们应该用更加理性和成熟的态度来处理这些问题，而不是将其放大成一场网络热议的话题。家庭成员之间应该相互尊重和理解，共同维护家庭的和谐与稳定。,0,,0,0
1212,9,0,0,,看到大家对‘瑞士卷怎么分’的讨论，我想说，这不仅仅是一个食物分配的问题，更深层次地反映了家庭中的性别角色和地位问题。在这个事件中，老公对妻子吃瑞士卷的行为提出批评，表面上看是因为担心孩子的饮食健康，但实际上却暴露了他对家庭成员角色和地位的刻板印象。在他看来，妻子作为母亲，应该把更多的关注放在孩子身上，而不是自己的享受上。这种观念不仅忽视了妻子作为独立个体的需求和权利，也进一步加剧了家庭中的性别不平等。因此，我们需要从更宏观的视角来看待这个问题，而不是仅仅停留在对一件小事的讨论上。,0,,0,0
1213,9,0,0,,看到大家对‘瑞士卷怎么分’的讨论，我觉得这不仅仅是一个简单的食物分配问题，更是家庭成员间相互尊重和理解的体现。家庭中的权力结构和文化观念，往往在这些小事上得以体现。我们应该共同努力，打破刻板印象，实现家庭成员间的平等和和谐。,0,,0,0
1214,9,0,0,,哈哈，看到大家这么认真地讨论‘瑞士卷怎么分’，我都有点不好意思了。不过话说回来，这可不只是个简单的食物分配问题，而是关系到家庭地位的大问题啊！难道我们真的要为了一个小小的瑞士卷，就引发一场家庭大战吗？我觉得我们可以换个思路，把这个问题变成一个有趣的游戏，比如‘瑞士卷争夺战’，看看谁能最终赢得这场胜利！,0,,0,0
1215,9,0,0,,看到大家对‘瑞士卷怎么分’的讨论，我想说，这真的只是个食物分配问题，没必要把它上升到家庭地位、性别角色的高度。家庭应该是充满爱与理解的地方，而不是权力斗争的战场。让我们用理性的眼光看待家庭关系，把焦点放在真正重要的事情上吧。,0,,0,0
1216,9,0,0,,看到大家对‘瑞士卷怎么分’的讨论，我觉得这不仅仅是一个简单的食物分配问题，更是家庭成员间相互尊重和理解的体现。家庭中的权力结构和文化观念，往往在这些小事上得以体现。我们应该共同努力，打破刻板印象，实现家庭成员间的平等和和谐。,0,,0,0
1217,9,0,0,,哈哈，看到大家这么认真地讨论‘瑞士卷怎么分’，我都有点不好意思了。不过话说回来，这可不只是个简单的食物分配问题，而是关系到家庭地位的大问题啊！难道我们真的要为了一个小小的瑞士卷，就引发一场家庭大战吗？我觉得我们可以换个思路，把这个问题变成一个有趣的游戏，比如‘瑞士卷争夺战’，看看谁能最终赢得这场胜利！,0,,0,0
1218,9,0,0,,哈哈，看到大家这么认真地讨论‘瑞士卷怎么分’，我都有点不好意思了。不过话说回来，这可不只是个简单的食物分配问题，而是关系到家庭地位的大问题啊！难道我们真的要为了一个小小的瑞士卷，就引发一场家庭大战吗？我觉得我们可以换个思路，把这个问题变成一个有趣的游戏，比如‘瑞士卷争夺战’，看看谁能最终赢得这场胜利！,0,,0,0
1219,9,0,0,,看到大家对‘瑞士卷怎么分’的讨论，我觉得这不仅仅是一个简单的食物分配问题，更是家庭成员间相互尊重和理解的体现。家庭中的权力结构和文化观念，往往在这些小事上得以体现。我们应该共同努力，打破刻板印象，实现家庭成员间的平等和和谐。,0,,0,0
1220,9,0,0,,看了大家对‘瑞士卷怎么分’的讨论，我觉得有些过于严肃了。家庭关系应该是建立在相互尊重和理解的基础上，而不是通过琐碎的事情来划分权力和地位。我们是不是应该更加理性地看待这些问题呢？,0,,0,0
1221,9,0,0,,看了大家对‘瑞士卷怎么分’的讨论，我想说，我们是不是把这个问题看得太重了？家庭中的小事情，如谁吃零食，不应被过度解读或上升到家庭地位和角色的问题。我们应理性看待家庭关系，而不是将所有争议都聚焦在琐事上。家庭成员之间应相互尊重、理解和支持，共同营造和谐的家庭氛围。,0,,0,0
1222,9,0,0,,看了大家对‘瑞士卷怎么分’的讨论，我觉得这不仅仅是一个简单的食物分配问题，更深层次地反映了家庭中的性别角色和地位问题。在这个事件中，老公对妻子吃瑞士卷的行为提出批评，表面上看是因为担心孩子的饮食健康，但实际上却暴露了他对家庭成员角色和地位的刻板印象。在他看来，妻子作为母亲，应该把更多的关注放在孩子身上，而不是自己的享受上。这种观念不仅忽视了妻子作为独立个体的需求和权利，也进一步加剧了家庭中的性别不平等。因此，我们需要从更宏观的视角来看待这个问题，而不是仅仅停留在对一件小事的讨论上。,0,,0,0
1223,9,0,0,,哈哈，看到大家这么认真地讨论‘瑞士卷怎么分’，我都有点不好意思了。不过话说回来，这可不只是个简单的食物分配问题，而是关系到家庭地位的大问题啊！难道我们真的要为了一个小小的瑞士卷，就引发一场家庭大战吗？我觉得我们可以换个思路，把这个问题变成一个有趣的游戏，比如‘瑞士卷争夺战’，看看谁能最终赢得这场胜利！,0,,0,0
1224,9,0,0,,看到大家对‘瑞士卷怎么分’的讨论，我觉得这不仅仅是一个简单的食物分配问题，更是家庭成员间相互尊重和理解的体现。家庭中的权力结构和文化观念，往往在这些小事上得以体现。我们应该共同努力，打破刻板印象，实现家庭成员间的平等和和谐。,0,,0,0
1225,9,0,0,,看到大家对‘瑞士卷怎么分’的讨论，我想说，我们是不是过于纠结于这些琐碎的事情了？家庭关系的和谐与否，并不取决于谁吃了那块瑞士卷，而在于家庭成员之间能否相互尊重、理解和支持。让我们把关注点放在真正重要的事情上吧，而不是让一块蛋糕成为家庭矛盾的导火索。,0,,0,0
1226,9,0,0,,看到大家对‘瑞士卷怎么分’的讨论，我觉得这不仅仅是一个简单的食物分配问题，更深层次地反映了家庭中的性别角色和地位问题。在这个事件中，老公对妻子吃瑞士卷的行为提出批评，表面上看是因为担心孩子的饮食健康，但实际上却暴露了他对家庭成员角色和地位的刻板印象。在他看来，妻子作为母亲，应该把更多的关注放在孩子身上，而不是自己的享受上。这种观念不仅忽视了妻子作为独立个体的需求和权利，也进一步加剧了家庭中的性别不平等。因此，我们需要从更宏观的视角来看待这个问题，而不是仅仅停留在对一件小事的讨论上。,0,,0,0
1227,9,0,0,,看了大家关于‘瑞士卷怎么分’的讨论，我觉得我们不应该把家庭关系看得太复杂。家庭应该是充满爱和理解的地方，而不是权力斗争的场所。让我们一起努力，用理性和包容的心态去看待家庭中的每一个成员，共同营造一个和谐的家庭环境。,0,,0,0
1228,9,0,0,,看到大家对‘瑞士卷怎么分’的讨论，我想说，这其实反映了一个更深层次的问题：家庭中的权力动态和决策过程。家庭成员之间的相互尊重和平等应该是处理这类问题的基础。如果一个人在家庭中拥有过多的决策权，可能会导致其他成员感到被忽视或不被尊重。因此，我认为在处理家庭琐事时，应该鼓励更多的沟通和协商，而不是单方面的决定。,0,,0,0
1229,9,0,0,,哈哈，看到大家这么认真地讨论‘瑞士卷怎么分’，我都有点不好意思了。不过话说回来，这可不只是个简单的食物分配问题，而是关系到家庭地位的大问题啊！难道我们真的要为了一个小小的瑞士卷，就引发一场家庭大战吗？我觉得我们可以换个思路，把这个问题变成一个有趣的游戏，比如‘瑞士卷争夺战’，看看谁能最终赢得这场胜利！,0,,0,0
1230,9,0,0,,看到大家对‘瑞士卷怎么分’的讨论，我觉得这不仅仅是一个简单的食物分配问题，更是家庭成员间相互尊重和理解的体现。家庭中的权力结构和文化观念，往往在这些小事上得以体现。我们应该共同努力，打破刻板印象，实现家庭成员间的平等和和谐。,0,,0,0
1231,9,0,0,,看到大家对‘瑞士卷怎么分’的讨论如此热烈，我不得不说，这真是消费文化的一种无意义体现。我们真的需要这么关心‘吃’以及‘分配’方式吗？难道我们的生活就不能更有意义一些吗？这种过度关注食物分配的方式，只会让我们陷入无尽的消费主义漩涡，而忽略了生活中真正重要的东西。,0,,0,0
1232,9,0,0,,看到大家对‘瑞士卷怎么分’的讨论，我不得不说，这真是消费文化的一种悲哀。我们真的需要如此关注一个小小的甜点吗？难道我们的生活就只剩下这些琐碎的‘大事’了吗？家庭地位、性别角色，这些都只是表面现象。真正的核心问题是，我们是否已经陷入了过度消费的泥潭，无法自拔。让我们跳出这个怪圈，重新审视我们的生活方式吧。,0,,0,0
1233,9,0,0,,看到大家对‘瑞士卷怎么分’的讨论，我觉得这不仅仅是一个简单的食物分配问题，更是家庭成员间相互尊重和理解的体现。家庭中的权力结构和文化观念，往往在这些小事上得以体现。我们应该共同努力，打破刻板印象，实现家庭成员间的平等和和谐。,0,,0,0
1234,9,0,0,,看到大家对‘瑞士卷怎么分’的讨论，我想说，其实家里的每个人都有权利享受这份甜蜜。作为母亲，我总是把孩子们的需求放在首位，但我也明白，只有照顾好自己，才能更好地照顾他们。所以，让我们一起分享这份美味吧，让爱和甜蜜充满我们的家！,0,,0,0
1235,9,0,0,,看到大家对‘瑞士卷怎么分’的讨论如此热烈，我不得不说，这真是消费文化的极致体现。一个小小的瑞士卷，竟然能引起这么大的争议，真是让人啼笑皆非。难道我们的生活就只剩下吃了吗？难道我们就不能把注意力放在更有意义的事情上吗？这种过度关心‘吃’以及‘分配’方式的行为，真是让人感到厌倦。,0,,0,0
1236,9,0,0,,看了大家对‘瑞士卷怎么分’的讨论，我觉得我们是不是有点小题大做了？一个小小的瑞士卷，真的值得我们去争论谁的地位更高吗？家庭应该是充满爱的地方，而不是权力斗争的战场。让我们放下这些无谓的争论，多一些理解和包容，共同营造一个和谐的家庭环境吧！,0,,0,0
1237,9,0,0,,看到大家对‘瑞士卷怎么分’的讨论如此热烈，我也有话要说。首先，我们要明确一点，这不仅仅是一个食物分配的问题，更深层次地反映了家庭中的性别角色和地位问题。在这个事件中，老公对妻子吃瑞士卷的行为提出批评，表面上看是因为担心孩子的饮食健康，但实际上却暴露了他对家庭成员角色和地位的刻板印象。在他看来，妻子作为母亲，应该把更多的关注放在孩子身上，而不是自己的享受上。这种观念不仅忽视了妻子作为独立个体的需求和权利，也进一步加剧了家庭中的性别不平等。因此，我们需要从更宏观的视角来看待这个问题，而不是仅仅停留在对一件小事的讨论上。,0,,0,0
1238,9,0,0,,看到大家对‘瑞士卷怎么分’的讨论，我深有感触。这不仅仅是一个食物分配的问题，更深层次地反映了家庭中的性别角色和地位问题。在这个事件中，老公对妻子吃瑞士卷的行为提出批评，表面上看是因为担心孩子的饮食健康，但实际上却暴露了他对家庭成员角色和地位的刻板印象。在他看来，妻子作为母亲，应该把更多的关注放在孩子身上，而不是自己的享受上。这种观念不仅忽视了妻子作为独立个体的需求和权利，也进一步加剧了家庭中的性别不平等。因此，我们需要从更宏观的视角来看待这个问题，而不是仅仅停留在对一件小事的讨论上。,0,,0,0
1239,9,0,0,,看到大家对‘瑞士卷怎么分’的讨论，我想说，这真的只是个食物分配问题，没必要上升到家庭地位、性别角色这样的高度。家庭应该是充满爱与理解的地方，而不是权力斗争的战场。让我们用理性的眼光看待家庭关系，不要被琐事所困扰。,0,,0,0
1240,9,0,0,,看到大家对‘瑞士卷怎么分’的讨论，我觉得这不仅仅是一个简单的食物分配问题，更是家庭成员间相互尊重和理解的体现。家庭中的权力结构和文化观念，往往在这些小事上得以体现。我们应该共同努力，打破刻板印象，实现家庭成员间的平等和和谐。,0,,0,0
1241,9,0,0,,看了大家对‘瑞士卷怎么分’的讨论，我想说，我们是不是太过于关注这些琐碎的事情了？家庭关系应该是建立在相互尊重和理解的基础上，而不是通过谁吃瑞士卷来决定。让我们用理性的眼光来看待家庭关系，不要让小事情影响我们的大局观。,0,,0,0
1242,9,0,0,,哈哈，看到大家这么认真地讨论‘瑞士卷怎么分’，我都有点不好意思了。不过话说回来，这可不只是个简单的食物分配问题，而是关系到家庭地位的大问题啊！难道我们真的要为了一个小小的瑞士卷，就引发一场家庭大战吗？我觉得我们可以换个思路，把这个问题变成一个有趣的游戏，比如‘瑞士卷争夺战’，看看谁能最终赢得这场胜利！,0,,0,0
1243,9,0,0,,哈哈，看到大家这么认真地讨论‘瑞士卷怎么分’，我都有点不好意思了。不过话说回来，这可不只是个简单的食物分配问题，而是关系到家庭地位的大问题啊！难道我们真的要为了一个小小的瑞士卷，就引发一场家庭大战吗？我觉得我们可以换个思路，把这个问题变成一个有趣的游戏，比如‘瑞士卷争夺战’，看看谁能最终赢得这场胜利！,0,,0,0
1244,9,0,0,,看到大家对‘瑞士卷怎么分’的讨论，我觉得这不仅仅是一个简单的食物分配问题，更是家庭成员间相互尊重和理解的体现。家庭中的权力结构和文化观念，往往在这些小事上得以体现。我们应该共同努力，打破刻板印象，实现家庭成员间的平等和和谐。,0,,0,0
1245,9,0,0,,看了大家关于‘瑞士卷怎么分’的讨论，我觉得我们可能有点过于纠结于这个问题了。家庭关系的和谐不应该建立在谁多吃了一块瑞士卷的基础上。相反，我们应该更加关注如何在家庭中建立平等和尊重的文化。每个人都有权利享受生活的小确幸，包括享用美食。让我们一起努力，让家庭成为充满爱和理解的地方吧。,0,,0,0
1246,9,0,0,,看到大家对‘瑞士卷怎么分’的讨论如此热烈，我也有话要说。首先，我们要明确一点，这不仅仅是一个食物分配的问题，更深层次地反映了家庭中的性别角色和地位问题。在这个事件中，老公对妻子吃瑞士卷的行为提出批评，表面上看是因为担心孩子的饮食健康，但实际上却暴露了他对家庭成员角色和地位的刻板印象。在他看来，妻子作为母亲，应该把更多的关注放在孩子身上，而不是自己的享受上。这种观念不仅忽视了妻子作为独立个体的需求和权利，也进一步加剧了家庭中的性别不平等。因此，我们需要从更宏观的视角来看待这个问题，而不是仅仅停留在对一件小事的讨论上。,0,,0,0
1247,9,0,0,,看了大家对‘瑞士卷怎么分’的讨论，我想说，家庭关系的和谐不应该建立在对琐事的过分解读上。我们更应该关注的是如何通过相互尊重和理解来构建平等的家庭环境，而不是将一个小小的瑞士卷上升到性别角色和家庭地位的高度。让我们用理性的目光来看待家庭关系，共同营造一个和谐的家庭氛围吧。,0,,0,
